token_id,Shooting,Defense,Vision,Finish,Total Boost
8760,35,52,44,41,172
1858,51,62,30,71,214
3509,33,70,16,34,153
5857,61,78,52,52,243
5353,55,83,27,60,225
1359,63,31,59,44,197
3009,47,43,15,38,143
3995,30,28,72,46,176
2974,35,53,46,61,195
9177,40,68,36,70,214
7760,37,47,59,28,171
8306,69,38,97,36,240
7990,18,43,46,52,159
8964,55,48,32,32,167
859,52,55,48,29,184
136,42,37,51,48,178
736,37,93,17,54,201
4807,69,47,24,38,178
1581,43,41,29,43,156
9157,42,58,58,51,209
8538,62,34,41,29,166
5732,50,58,52,48,208
4790,41,84,44,62,231
8552,72,79,67,63,281
2760,54,49,54,36,193
2504,67,65,40,45,217
3988,34,41,45,44,164
6059,66,69,62,45,242
3767,54,35,61,42,192
5328,42,66,51,33,192
2584,33,52,40,53,178
4312,50,46,36,37,169
6507,47,73,38,41,199
8152,56,52,73,67,248
2679,48,67,33,27,175
2431,19,26,57,55,157
9773,93,44,40,41,218
3745,47,91,0,34,172
2871,45,75,79,48,247
3064,62,51,56,36,205
4797,74,61,88,38,261
9150,37,36,49,39,161
7310,58,58,32,70,218
8200,25,47,63,60,195
7938,48,41,57,63,209
101,51,53,71,55,230
9954,60,36,43,56,195
8138,32,68,41,53,194
9256,47,57,59,43,206
5915,59,44,47,77,227
6015,36,57,59,36,188
3614,37,56,37,29,159
8063,61,60,49,59,229
1780,51,54,46,60,211
5006,37,56,62,44,199
9281,73,45,64,41,223
9500,60,22,44,38,164
4129,74,55,68,30,227
8699,56,45,52,38,191
853,43,45,62,39,189
2185,32,43,58,60,193
3321,63,42,37,39,181
7331,52,22,44,72,190
5746,51,39,28,57,175
4739,62,62,64,35,223
4702,70,57,36,52,215
9920,43,49,55,36,183
1097,61,67,38,72,238
3539,51,57,47,33,188
2810,44,58,32,38,172
1039,61,38,38,84,221
5178,67,44,38,50,199
8366,19,21,36,47,123
4462,69,42,56,48,215
1162,54,68,59,48,229
2724,69,57,32,59,217
1409,30,48,48,55,181
3706,36,43,52,36,167
2868,60,55,41,35,191
4555,74,57,33,39,203
1920,16,58,51,33,158
5650,46,71,42,82,241
3600,75,20,69,47,211
4350,40,43,40,71,194
6690,49,50,34,30,163
3753,42,50,46,49,187
9876,36,28,60,49,173
5144,81,14,54,59,208
5718,47,72,73,29,221
4454,39,43,34,38,154
9344,59,79,44,67,249
910,54,70,47,44,215
5324,56,34,30,34,154
6840,57,67,89,71,284
5433,41,52,57,28,178
6647,55,44,22,47,168
5808,50,49,38,59,196
5216,66,68,58,66,258
4320,70,71,37,84,262
4729,28,41,34,64,167
4109,58,60,32,33,183
4791,36,47,65,76,224
9674,58,44,46,57,205
3197,31,61,77,69,238
596,65,83,57,55,260
1339,44,53,53,50,200
8625,77,68,59,60,264
4566,34,38,59,49,180
2710,42,56,73,51,222
3675,50,39,53,38,180
8102,38,41,49,60,188
7486,1,66,59,38,164
9442,42,54,43,93,232
5635,21,5,58,23,107
2623,64,71,67,89,291
1168,43,44,28,44,159
8753,62,16,56,55,189
2987,38,42,66,41,187
7338,20,54,54,46,174
6849,50,51,53,70,224
4447,43,33,40,75,191
7729,48,62,51,44,205
9734,75,53,67,55,250
5591,30,46,57,62,195
7569,56,9,50,23,138
9491,52,32,58,10,152
9813,50,67,22,71,210
9820,46,23,50,57,176
3143,60,50,65,41,216
3737,48,71,23,41,183
4956,61,52,58,30,201
4275,85,54,29,67,235
8732,51,45,62,56,214
2678,67,21,59,48,195
3000,53,58,23,80,214
232,71,56,33,36,196
2506,63,37,44,47,191
8243,34,45,46,45,170
645,56,50,69,20,195
9698,53,31,72,65,221
3405,47,58,63,40,208
8233,47,49,64,41,201
2510,58,61,61,47,227
25,46,7,50,40,143
8702,53,52,72,43,220
1645,74,71,69,29,243
211,63,65,69,34,231
2260,42,53,38,43,176
1760,43,41,59,33,176
782,57,21,36,43,157
1027,52,56,60,72,240
3325,42,48,30,61,181
8135,39,29,48,53,169
1110,54,35,69,51,209
1966,74,52,34,52,212
2499,62,47,55,58,222
7920,46,62,37,48,193
742,27,62,62,50,201
7651,56,45,58,33,192
8850,79,48,81,64,272
210,60,54,54,46,214
4630,36,44,34,31,145
9897,65,16,48,69,198
5465,41,33,72,60,206
4999,43,62,49,40,194
2473,40,48,44,22,154
132,50,57,90,67,264
4341,48,66,64,25,203
2161,47,65,28,45,185
3564,49,64,25,66,204
2250,37,44,32,45,158
932,39,32,49,51,171
5194,47,51,49,21,168
8616,35,64,44,62,205
2377,48,57,40,27,172
2496,28,58,58,33,177
7537,19,38,41,37,135
9570,55,44,67,56,222
4603,53,62,51,57,223
2935,79,50,60,26,215
9057,63,52,56,15,186
6670,15,51,39,17,122
1665,29,24,38,55,146
1265,30,56,60,42,188
8336,26,45,85,58,214
6718,43,71,57,34,205
4677,51,70,67,72,260
3172,46,55,26,38,165
505,52,87,23,57,219
4089,75,23,51,54,203
4477,47,39,23,67,176
2502,53,52,60,60,225
6200,79,55,59,34,227
5719,22,83,58,75,238
8262,53,30,58,48,189
3506,33,41,50,53,177
915,45,51,0,33,129
4918,22,14,46,30,112
6438,49,86,61,29,225
9797,48,24,69,35,176
1914,29,29,39,10,107
6204,67,48,70,41,226
9928,71,58,41,42,212
5533,56,15,60,32,163
1065,51,50,57,44,202
2164,58,43,54,61,216
5351,33,74,61,45,213
1775,63,69,32,64,228
8440,51,35,83,62,231
1556,32,48,34,42,156
3396,58,49,25,39,171
8780,41,62,69,42,214
2174,69,55,39,53,216
4740,52,41,74,70,237
1216,58,73,45,31,207
5679,50,59,36,46,191
2919,49,14,60,28,151
4592,52,42,52,50,196
4176,68,54,33,48,203
41,35,59,40,41,175
8100,43,53,49,66,211
8939,30,17,53,65,165
2795,36,64,53,55,208
5484,57,79,68,44,248
6102,70,53,64,11,198
7945,47,59,56,60,222
1238,32,52,82,71,237
495,56,70,53,2,181
995,57,43,34,44,178
6005,47,58,46,70,221
4278,61,65,62,65,253
7668,58,73,58,65,254
7660,71,43,51,23,188
7757,55,78,45,55,233
8821,38,42,68,43,191
2544,39,67,49,49,204
2560,52,60,44,83,239
7530,52,35,64,62,213
5837,63,32,57,47,199
5770,53,48,52,64,217
6932,62,54,58,33,207
5498,72,47,75,58,252
8937,58,55,89,76,278
5246,29,66,38,61,194
6413,56,49,39,61,205
3752,68,72,59,61,260
8285,45,64,29,56,194
49,55,26,59,36,176
6607,47,68,62,67,244
9331,46,48,72,19,185
7655,58,35,56,21,170
6590,46,42,41,60,189
74,69,54,31,58,212
135,25,51,57,44,177
7783,58,62,71,49,240
80,67,61,50,16,194
1843,54,60,40,42,196
5920,36,49,28,66,179
4208,50,51,63,58,222
3296,38,45,43,42,168
3182,47,51,61,39,198
1894,46,25,46,44,161
6586,46,49,51,54,200
5120,86,90,60,13,249
2698,56,50,34,87,227
184,54,66,32,31,183
4660,56,69,36,51,212
6332,57,49,80,44,230
5391,46,45,76,63,230
1883,22,80,76,71,249
6022,19,60,62,53,194
4201,57,42,81,44,224
3195,41,57,24,56,178
5628,68,60,56,41,225
6644,44,53,61,51,209
265,41,65,56,20,182
8763,30,37,55,61,183
7072,47,54,59,7,167
1172,78,60,48,49,235
8929,51,53,52,27,183
9678,37,60,64,60,221
6910,36,56,48,34,174
2923,69,34,66,34,203
7316,60,61,79,62,262
6089,37,36,30,52,155
6899,65,49,46,47,207
7431,29,13,46,38,126
3586,41,56,61,72,230
8849,63,61,70,38,232
2032,55,24,71,59,209
5962,61,55,45,15,176
3893,76,43,42,38,199
9454,51,45,45,26,167
3734,46,51,65,47,209
1802,63,61,40,56,220
2922,24,24,46,60,154
2198,42,46,81,37,206
3759,43,21,50,28,142
6889,55,44,21,39,159
3844,78,45,38,37,198
1016,37,68,29,47,181
3700,77,48,57,58,240
7553,28,54,49,69,200
8877,68,60,57,37,222
9159,54,58,61,29,202
3450,64,60,33,62,219
9069,66,47,79,52,244
9207,58,56,68,71,253
4922,58,50,36,68,212
3720,28,29,51,22,130
9472,53,72,75,39,239
9748,21,64,22,55,162
8899,71,52,50,49,222
3713,41,68,46,51,206
9323,38,20,50,36,144
234,59,43,76,47,225
5457,56,44,72,25,197
9255,70,46,56,42,214
3732,33,59,51,67,210
2503,64,71,30,76,241
5608,36,40,45,83,204
7115,44,51,37,37,169
7825,21,27,59,54,161
1988,48,40,45,62,195
8957,58,53,79,32,222
1066,50,39,34,62,185
6356,40,76,81,77,274
9481,67,52,55,51,225
4480,49,35,36,78,198
6881,20,71,23,37,151
8598,38,46,45,65,194
8221,59,70,48,55,232
2593,34,42,57,66,199
8142,57,63,23,55,198
8400,71,68,32,52,223
3215,80,34,46,48,208
7598,46,39,60,35,180
461,55,55,58,47,215
4885,59,65,40,46,210
8574,19,51,30,32,132
451,52,48,62,53,215
8127,29,92,81,66,268
5334,57,41,40,27,165
9211,29,37,61,37,164
817,39,63,43,44,189
8017,14,38,54,45,151
1263,44,19,49,52,164
8022,40,54,68,64,226
8097,53,28,43,58,182
8125,48,46,73,77,244
1944,66,63,47,32,208
2429,27,38,39,54,158
2775,42,41,57,62,202
6599,48,59,62,53,222
9257,47,64,63,49,223
1904,54,39,72,35,200
410,54,20,47,37,158
5421,50,61,55,54,220
502,53,27,30,48,158
7067,50,63,46,66,225
3695,35,15,72,52,174
5079,44,22,53,40,159
6353,60,51,74,15,200
5308,37,67,66,23,193
3528,53,23,18,33,127
51,52,66,28,28,174
7531,79,56,81,52,268
7744,65,58,52,38,213
6513,60,54,50,6,170
2684,54,78,55,36,223
4245,51,39,60,43,193
6750,37,63,61,22,183
9251,59,47,59,48,213
3611,45,76,54,9,184
7203,53,27,62,56,198
94,56,50,51,58,215
8143,50,55,34,47,186
2315,43,8,53,46,150
7717,46,72,34,47,199
2701,58,54,34,9,155
3783,23,37,25,36,121
5912,25,41,31,52,149
6283,67,52,32,66,217
931,56,59,49,43,207
3920,36,54,20,22,132
6926,44,27,55,59,185
6330,0,61,31,28,120
4535,55,56,27,31,169
690,44,75,55,34,208
9078,46,47,46,61,200
4938,43,41,76,59,219
7224,50,73,68,82,273
2247,40,57,51,44,192
3084,58,49,4,52,163
3524,39,37,43,38,157
8918,55,43,54,63,215
1382,68,55,37,53,213
6344,36,40,79,55,210
912,44,20,19,47,130
3794,52,39,47,59,197
2219,57,54,44,44,199
8977,34,53,49,25,161
4822,10,27,35,74,146
2774,29,48,17,47,141
7842,45,52,46,54,197
5443,47,70,24,42,183
7492,37,50,47,50,184
1866,60,36,50,57,203
7558,46,79,62,52,239
6535,67,59,35,45,206
2869,53,50,89,42,234
636,62,57,51,66,236
2099,49,30,51,7,137
1884,31,59,35,60,185
9359,80,63,61,61,265
9092,55,20,17,58,150
27,38,94,41,11,184
3670,70,40,68,72,250
8605,27,54,60,15,156
6819,72,41,29,70,212
2444,20,40,45,22,127
320,53,38,42,50,183
8456,30,50,49,75,204
9531,62,30,46,62,200
4856,24,63,61,63,211
3879,36,32,50,37,155
1848,44,31,61,55,191
8901,79,32,70,58,239
7644,59,52,45,48,204
6500,75,37,45,72,229
1391,94,57,55,69,275
8207,63,49,51,56,219
2538,29,48,52,44,173
6636,54,26,46,51,177
3696,54,33,66,33,186
3512,39,33,53,67,192
3653,37,46,87,45,215
4177,33,60,54,0,147
7460,33,40,57,21,151
670,57,64,50,73,244
8021,47,46,68,40,201
5904,52,73,32,74,231
6920,34,46,46,58,184
2491,7,61,67,64,199
9247,35,41,54,56,186
6364,44,41,40,59,184
9134,60,28,41,72,201
3743,48,54,41,73,216
6964,55,78,70,21,224
46,35,57,52,44,188
7288,39,58,37,100,234
8524,61,49,45,56,211
4811,48,37,67,60,212
5499,23,44,81,52,200
6580,55,46,46,55,202
6979,50,50,44,57,201
599,30,42,57,44,173
8729,73,75,68,37,253
9439,33,41,42,55,171
8835,73,67,45,48,233
2634,77,50,30,46,203
7673,18,52,42,46,158
9362,29,55,49,29,162
4927,30,63,77,56,226
994,68,58,34,58,218
3452,31,58,75,33,197
6107,70,59,45,63,237
9212,46,44,54,74,218
472,63,61,57,40,221
1969,39,29,88,60,216
9322,46,48,44,40,178
6465,33,71,77,67,248
9343,39,49,23,49,160
8365,42,29,33,59,163
2221,82,72,57,67,278
5295,57,22,60,60,199
8176,28,63,55,45,191
1464,79,79,56,26,240
6365,30,47,28,82,187
8970,47,31,39,58,175
2390,51,45,35,31,162
9789,49,58,46,46,199
824,47,39,74,54,214
5703,55,54,72,65,246
7197,55,35,32,43,165
6143,58,49,62,41,210
8946,25,40,19,64,148
5569,81,54,30,52,217
358,51,51,51,28,181
380,64,55,25,48,192
9082,39,39,50,66,194
415,36,23,32,19,110
2579,62,49,23,32,166
7888,50,44,59,30,183
6466,67,38,40,82,227
1235,51,50,52,92,245
8603,46,42,49,61,198
6977,20,50,54,72,196
8045,36,39,49,54,178
848,68,66,65,45,244
325,73,71,53,65,262
8652,30,74,57,59,220
8317,52,65,88,51,256
4283,54,59,37,37,187
9411,38,87,31,47,203
9035,49,35,21,56,161
6457,53,49,55,64,221
8789,58,49,30,37,174
6521,55,61,38,54,208
2448,39,39,79,61,218
5945,69,67,45,28,209
3796,33,52,74,58,217
1827,38,59,35,68,200
284,42,53,33,57,185
2259,72,50,41,43,206
368,50,40,50,32,172
5542,34,75,50,69,228
8662,58,38,61,38,195
5620,62,58,50,58,228
8069,34,38,54,71,197
9483,38,69,45,71,223
3938,57,37,33,87,214
3362,57,51,60,32,200
2125,73,84,43,59,259
1698,54,55,34,50,193
2780,64,42,55,60,221
5491,34,20,70,38,162
4637,47,43,90,40,220
5734,51,19,63,52,185
5342,57,49,53,48,207
2911,47,33,32,68,180
3298,53,50,46,40,189
2181,31,43,72,55,201
6734,56,42,39,86,223
2085,68,43,65,55,231
8332,40,62,73,35,210
715,54,65,41,36,196
1637,41,36,59,51,187
4473,72,52,38,48,210
875,69,40,55,34,198
7328,49,36,51,58,194
754,55,63,27,67,212
4957,39,53,50,33,175
5162,46,29,41,60,176
4728,44,34,46,59,183
2242,52,46,55,43,196
5449,31,24,39,52,146
6322,65,56,58,49,228
8557,59,35,40,15,149
6001,61,52,47,64,224
3494,58,42,55,58,213
7767,66,30,59,22,177
1002,54,53,45,58,210
5995,34,33,70,73,210
4197,39,26,57,57,179
3888,42,53,71,44,210
8202,50,51,76,34,211
4758,53,38,69,58,218
3739,46,41,45,43,175
585,50,49,45,53,197
2583,31,73,48,60,212
1970,39,24,27,80,170
1585,41,31,35,35,142
8287,87,54,23,76,240
9696,47,36,60,60,203
8980,57,46,60,61,224
3399,79,86,45,45,255
9303,47,38,54,53,192
4954,50,71,57,39,217
8259,67,47,40,46,200
3140,35,59,70,40,204
9843,60,65,39,44,208
8086,64,42,21,54,181
5234,66,71,89,54,280
1820,55,65,60,36,216
6960,54,39,42,74,209
3048,55,48,47,71,221
6890,48,45,60,45,198
1767,57,60,68,44,229
3659,48,40,39,80,207
1245,57,73,49,55,234
5217,44,47,66,62,219
6134,58,50,41,53,202
5012,32,38,47,69,186
6387,67,44,31,50,192
1349,28,70,58,62,218
312,61,25,47,57,190
3079,35,46,58,63,202
850,50,52,83,57,242
7131,56,52,36,71,215
8762,55,76,42,57,230
2797,57,65,40,37,199
686,47,49,39,75,210
906,65,46,42,59,212
4266,25,40,56,54,175
8911,37,67,79,49,232
1740,44,73,50,22,189
9486,20,53,56,49,178
9197,65,42,54,38,199
4229,65,46,55,49,215
7955,30,30,33,50,143
2017,50,58,36,33,177
1671,34,76,24,51,185
5434,42,52,96,32,222
2605,46,36,83,58,223
6721,47,52,41,39,179
9079,48,61,54,69,232
8585,78,62,60,45,245
5280,48,54,51,53,206
5697,58,66,73,66,263
3697,40,49,56,63,208
3458,30,28,60,65,183
7455,47,77,42,42,208
6600,64,46,25,53,188
3955,50,45,38,31,164
2251,18,60,57,68,203
12,63,38,30,67,198
8354,39,60,64,36,199
7212,57,48,42,56,203
7805,29,71,53,41,194
4981,56,37,46,28,167
2305,61,14,37,74,186
9754,85,52,44,19,200
6318,41,69,38,59,207
8024,42,46,42,65,195
6983,66,60,83,45,254
1300,70,51,47,58,226
2754,48,44,34,26,152
4542,54,42,51,100,247
8162,65,35,39,51,190
4358,74,35,70,54,233
8019,48,57,65,64,234
3676,51,31,62,63,207
2637,48,44,55,34,181
4787,34,67,52,50,203
5658,51,42,61,47,201
8028,78,62,74,34,248
8003,52,64,90,73,279
2024,56,67,54,66,243
2829,53,75,57,28,213
7044,44,36,84,13,177
8782,34,48,78,28,188
8418,26,51,48,52,177
4722,73,75,47,73,268
5088,68,43,47,53,211
4623,26,59,75,92,252
4206,47,48,25,24,144
8002,37,48,45,38,168
6962,57,52,45,63,217
6843,47,32,61,62,202
9248,43,60,42,44,189
8961,76,44,19,26,165
55,20,38,21,13,92
289,61,35,60,66,222
7901,64,34,33,63,194
8936,38,76,42,37,193
3389,70,21,44,52,187
4663,42,72,49,49,212
999,68,35,39,58,200
5738,40,32,25,45,142
8843,54,38,44,21,157
9195,68,60,62,77,267
4700,52,63,74,31,220
4890,40,44,46,39,169
7565,78,39,56,72,245
3451,33,67,55,50,205
1046,42,59,67,35,203
9857,26,29,35,21,111
7872,92,48,52,50,242
9682,38,73,71,29,211
2771,30,41,9,49,129
3990,67,45,34,71,217
6844,59,52,39,77,227
477,47,63,34,27,171
924,57,44,40,32,173
9581,68,7,43,68,186
9804,96,71,39,48,254
8945,62,38,49,63,212
2486,20,43,49,60,172
4931,55,61,59,48,223
1178,89,26,21,64,200
45,45,50,25,56,176
5750,13,38,55,62,168
4294,33,47,52,47,179
3554,44,62,73,49,228
274,66,50,79,63,258
2205,16,84,61,39,200
7001,42,46,52,38,178
4076,51,36,56,41,184
6993,60,78,59,57,254
6152,73,58,67,48,246
359,52,37,75,46,210
6895,62,58,46,61,227
8065,48,62,60,50,220
96,31,42,43,49,165
7826,51,46,51,67,215
5245,13,53,30,74,170
3037,48,31,13,60,152
4369,33,27,53,43,156
8101,100,34,68,44,246
5289,55,52,59,68,234
7661,81,34,51,69,235
9545,31,3,39,59,132
4104,55,57,45,51,208
3980,36,67,46,24,173
2956,46,42,19,64,171
9641,54,55,67,66,242
5063,21,35,64,41,161
4136,60,35,15,39,149
6069,32,37,69,26,164
3160,31,27,92,49,199
8947,52,52,74,42,220
565,52,55,33,53,193
5215,57,64,57,50,228
2270,57,53,69,88,267
8815,62,0,32,68,162
8455,49,77,69,52,247
6291,51,34,44,50,179
4525,25,35,59,18,137
9258,55,29,51,52,187
3779,31,13,49,65,158
2666,61,84,72,58,275
5094,38,42,48,55,183
2027,91,39,35,46,211
141,51,46,55,26,178
6113,33,55,35,70,193
4958,52,46,58,28,184
2043,43,19,58,43,163
5908,29,42,63,29,163
601,52,57,62,33,204
6331,51,72,53,40,216
5917,65,69,37,30,201
6628,53,19,35,48,155
1001,45,37,54,32,168
8145,79,58,52,57,246
2556,42,54,50,48,194
2152,41,34,28,30,133
2118,30,34,68,48,180
650,54,31,50,81,216
8257,58,50,49,54,211
6680,40,74,49,56,219
4568,37,67,66,47,217
6883,63,26,45,62,196
3672,60,24,53,58,195
7478,30,45,51,16,142
5035,76,40,53,35,204
538,52,35,61,57,205
5543,26,28,40,68,162
518,76,21,38,61,196
8790,39,61,57,56,213
4461,22,44,33,30,129
8566,38,74,48,28,188
9561,40,31,56,48,175
8410,40,52,23,65,180
1993,41,43,40,57,181
9634,72,49,46,55,222
9683,60,36,52,65,213
2624,64,37,55,46,202
891,65,51,60,48,224
1989,62,65,48,59,234
2527,53,58,55,43,209
5581,63,75,49,63,250
6230,25,68,37,11,141
5253,29,50,17,48,144
7013,61,74,47,15,197
4666,36,59,38,77,210
2150,67,69,52,15,203
4363,37,51,88,33,209
3240,35,69,50,33,187
8096,61,51,43,72,227
9100,64,43,81,34,222
9688,50,51,62,62,225
7956,54,74,33,40,201
2089,54,67,79,23,223
6566,51,48,46,88,233
4038,64,58,33,55,210
9714,57,94,53,55,259
9562,48,52,38,61,199
7059,64,45,59,60,228
8627,41,42,69,31,183
8794,36,39,38,43,156
9708,41,43,67,43,194
9016,37,69,51,44,201
291,76,35,56,35,202
5041,42,62,47,53,204
7796,78,57,53,35,223
6785,53,50,34,46,183
9329,67,76,64,55,262
2326,44,76,32,61,213
1048,44,66,43,36,189
5147,68,15,58,49,190
3728,43,66,45,37,191
2430,58,74,36,37,205
89,28,42,22,38,130
4991,60,56,22,26,164
9764,57,44,64,66,231
8018,66,62,52,52,232
9872,85,68,78,26,257
2234,49,47,35,28,159
9299,77,40,58,14,189
9726,41,68,69,59,237
8586,48,54,50,29,181
3606,43,34,66,58,201
9799,24,44,62,48,178
9724,29,60,72,51,212
8711,64,50,39,35,188
3968,36,49,39,61,185
39,57,77,70,41,245
6178,68,41,44,23,176
3411,39,18,68,29,154
5338,46,46,57,40,189
6213,73,53,28,10,164
104,54,38,59,60,211
5890,38,65,31,33,167
9488,53,56,72,12,193
3110,49,21,31,57,158
6771,78,54,56,52,240
8034,47,65,33,45,190
2778,33,47,54,69,203
8504,38,66,43,63,210
5672,77,27,69,53,226
8522,31,79,56,40,206
3927,42,42,19,63,166
9166,50,82,46,39,217
4720,47,23,65,23,158
1254,59,37,56,83,235
7525,81,57,73,19,230
8361,60,51,39,33,183
9402,59,60,53,70,242
7718,46,47,57,46,196
450,44,51,68,25,188
9280,25,28,34,47,134
6025,40,50,38,55,183
3942,70,33,61,61,225
5868,30,94,87,73,284
4490,29,56,56,32,173
9145,74,63,38,36,211
7911,82,75,50,44,251
1257,34,30,61,38,163
7467,60,30,32,70,192
4265,10,63,42,50,165
8294,36,39,30,54,159
445,69,34,51,49,203
4321,43,34,28,41,146
3906,46,60,29,20,155
5039,57,42,55,14,168
5436,36,71,32,39,178
4251,25,35,67,51,178
2007,42,42,55,68,207
5905,43,50,33,47,173
2693,56,73,77,55,261
1570,46,37,42,66,191
8656,60,53,11,68,192
3667,24,39,46,39,148
5670,63,31,53,35,182
7297,61,53,61,53,228
2764,38,61,32,35,166
8493,80,38,65,63,246
9176,36,73,32,87,228
9052,38,39,67,49,193
1043,39,52,24,51,166
9493,38,58,37,59,192
7097,21,62,58,51,192
2925,70,23,43,43,179
4172,58,81,30,35,204
4608,12,29,46,51,138
1932,36,52,63,68,219
7713,47,43,46,79,215
8214,50,53,49,44,196
9952,43,54,64,42,203
1807,81,41,32,44,198
4632,14,18,33,48,113
3814,71,48,43,64,226
8399,51,67,50,79,247
3797,43,24,38,37,142
8847,56,26,38,38,158
1690,48,55,65,26,194
9844,59,28,65,33,185
9527,49,52,69,39,209
4221,56,35,65,49,205
4645,43,53,39,88,223
841,41,57,66,57,221
418,53,60,74,22,209
1643,61,38,56,64,219
9824,47,24,46,39,156
6250,46,66,52,31,195
5536,57,76,41,29,203
8052,40,24,49,45,158
1405,58,29,44,47,178
304,59,63,52,76,250
1610,59,67,33,47,206
8927,57,39,50,29,175
9553,38,75,21,50,184
2350,74,61,55,46,236
6065,37,55,42,61,195
4648,52,55,35,32,174
7907,68,49,49,8,174
6244,46,65,41,60,212
9029,62,44,74,53,233
2197,79,35,47,59,220
9740,62,53,43,27,185
9213,53,72,91,47,263
42,44,66,8,73,191
6478,50,49,35,74,208
1892,57,35,47,37,176
6238,65,33,39,93,230
9903,44,50,54,70,218
2737,49,70,27,29,175
9651,37,66,35,63,201
2254,41,37,46,65,189
5042,36,62,45,59,202
8342,51,71,52,55,229
7662,97,78,22,46,243
4248,42,33,51,51,177
2030,62,58,48,65,233
5662,65,56,48,41,210
6955,62,37,51,64,214
428,26,66,66,49,207
9058,44,39,46,68,197
9541,71,47,43,44,205
8230,42,61,54,36,193
3093,47,41,36,52,176
6139,57,67,73,74,271
3011,57,70,28,27,182
6807,48,52,80,33,213
9087,84,69,77,42,272
5292,51,54,30,42,177
1499,53,21,53,26,153
983,66,85,77,44,272
7513,42,38,58,64,202
711,35,67,17,59,178
6146,53,76,41,49,219
4495,62,22,63,58,205
3883,96,51,67,27,241
7477,18,43,63,57,181
2677,51,33,44,46,174
4071,62,24,37,45,168
7749,59,73,64,43,239
4966,53,49,46,65,213
9786,23,56,52,91,222
8116,38,44,76,46,204
8319,60,50,71,44,225
2516,24,81,49,61,215
9039,54,42,50,61,207
7242,41,63,29,47,180
2330,43,38,48,45,174
8442,38,66,67,55,226
6226,48,56,62,52,218
4857,59,71,20,69,219
3184,33,68,70,47,218
7399,42,44,46,15,147
7797,68,53,58,28,207
4627,44,51,39,49,183
1122,47,32,46,48,173
2658,48,63,42,47,200
1479,56,22,52,15,145
20,51,54,52,33,190
9655,71,50,53,63,237
421,43,0,53,53,149
9135,75,51,19,56,201
2195,67,46,76,45,234
3187,71,33,59,87,250
3831,61,34,74,69,238
592,38,36,35,40,149
5653,46,51,39,41,177
6130,50,46,31,68,195
7711,34,55,54,44,187
3866,49,46,63,62,220
5382,51,38,40,69,198
8368,50,46,36,0,132
1256,60,61,41,16,178
2822,51,52,42,70,215
1688,44,37,71,37,189
762,56,27,34,78,195
4597,29,69,50,25,173
2966,11,67,41,49,168
6632,57,24,54,51,186
7877,61,55,52,72,240
7127,43,34,66,66,209
8649,32,53,43,42,170
7481,58,56,61,56,231
6066,58,31,29,79,197
5186,60,49,48,64,221
2909,48,53,68,34,203
4502,35,38,47,46,166
7735,54,31,58,36,179
3558,78,52,64,68,262
9906,50,35,54,47,186
9479,53,60,38,50,201
8996,48,56,75,54,233
93,35,73,50,48,206
1475,66,83,41,42,232
5096,63,31,67,57,218
9196,55,80,52,45,232
6456,49,25,25,44,143
8856,59,35,51,19,164
1301,47,67,49,39,202
2886,21,67,69,22,179
7898,55,55,40,64,214
9606,49,39,44,62,194
1364,67,58,38,47,210
5676,60,100,78,53,291
5303,53,45,33,33,164
5403,0,81,58,34,173
5702,39,30,54,28,151
3223,34,32,42,20,128
5163,53,30,30,36,149
7557,75,44,56,51,226
7775,44,73,56,72,245
751,77,51,47,45,220
1951,46,20,55,55,176
5220,44,48,28,73,193
671,53,31,63,56,203
8622,35,51,51,61,198
8376,22,85,46,42,195
8825,29,52,25,60,166
6392,49,65,51,37,202
9174,28,52,66,69,215
4475,36,45,34,65,180
3130,49,50,31,64,194
1860,25,81,39,78,223
6205,45,20,55,92,212
4769,40,52,43,55,190
8547,33,40,17,49,139
694,26,43,40,53,162
2041,58,64,46,39,207
7107,63,54,34,22,173
2905,61,23,67,70,221
8224,42,33,55,29,159
5137,39,35,39,45,158
3572,46,69,64,58,237
7408,50,59,54,93,256
9809,63,51,56,52,222
1649,79,65,30,37,211
6150,53,44,32,31,160
5827,14,15,21,27,77
7658,31,55,41,46,173
4406,65,48,70,24,207
4884,62,38,16,60,176
32,33,32,82,68,215
1789,50,41,43,39,173
7054,32,53,64,44,193
860,31,45,45,47,168
5957,53,21,66,7,147
109,42,40,52,61,195
9690,18,81,50,37,186
7232,39,57,50,74,220
8700,60,31,35,39,165
1340,18,63,60,62,203
1739,67,49,48,29,193
3363,44,42,64,61,211
7512,28,56,52,56,192
2714,54,67,47,66,234
8186,35,51,52,22,160
724,39,36,61,69,205
6913,98,73,62,50,283
8041,53,44,47,41,185
7024,75,54,46,38,213
1754,64,42,49,33,188
2973,47,48,49,68,212
434,30,78,37,52,197
9360,47,48,78,49,222
1644,33,62,36,46,177
5928,54,58,2,82,196
6519,51,75,35,49,210
870,36,66,60,23,185
481,45,50,47,47,189
8433,51,49,62,66,228
3630,51,48,69,45,213
9995,23,70,59,36,188
2916,11,67,56,41,175
4371,63,22,52,12,149
5967,48,34,46,53,181
8511,58,23,56,54,191
5196,36,27,59,50,172
5893,54,37,60,60,211
5909,22,39,56,43,160
8758,50,25,53,57,185
3162,44,48,42,58,192
3869,32,77,50,29,188
350,60,42,44,35,181
206,42,47,57,50,196
5451,31,32,29,55,147
4112,46,27,47,26,146
9887,51,38,52,46,187
9162,44,48,42,36,170
8846,55,58,55,55,223
5575,49,52,37,43,181
8489,31,59,37,62,189
4455,43,21,64,38,166
3124,56,61,45,45,207
5561,65,41,58,43,207
4459,67,42,57,51,217
8107,51,46,51,46,194
4144,40,37,63,33,173
9291,93,82,40,63,278
1908,42,46,51,24,163
43,66,36,58,49,209
5612,42,35,54,80,211
7576,41,60,39,40,180
5361,34,37,30,13,114
9909,57,48,41,49,195
6944,57,32,51,50,190
8404,77,53,49,58,237
3865,57,53,60,51,221
8390,38,38,76,55,207
7098,46,45,47,17,155
3861,50,35,65,25,175
8555,28,50,36,16,130
391,22,44,26,73,165
3485,55,44,10,54,163
4471,67,32,47,37,183
7124,33,25,87,23,168
7692,44,42,44,39,169
4096,55,51,26,68,200
2296,51,76,40,50,217
3845,27,33,59,49,168
8387,61,78,54,42,235
5768,62,54,64,63,243
5534,51,46,38,61,196
4992,37,67,30,72,206
8926,69,76,64,54,263
812,27,46,48,43,164
3994,38,49,21,46,154
5566,31,47,61,32,171
7712,46,58,32,63,199
6037,41,68,58,6,173
3373,66,49,31,64,210
2825,76,58,70,65,269
6415,44,36,75,38,193
3641,38,45,77,40,200
5057,67,60,69,61,257
7185,33,68,42,44,187
697,40,2,25,52,119
8668,37,61,51,43,192
4494,31,54,52,44,181
7708,56,50,54,29,189
5219,36,45,77,56,214
963,60,41,51,41,193
1399,44,58,47,48,197
8204,52,53,72,36,213
105,53,57,63,54,227
3148,16,53,33,31,133
9543,58,26,45,41,170
5869,36,48,44,86,214
6623,76,57,53,62,248
564,60,34,39,38,171
2884,55,37,51,51,194
2371,67,69,50,63,249
4924,36,33,65,85,219
2469,65,30,70,70,235
5790,72,29,30,58,189
8772,54,35,66,67,222
5936,63,36,68,38,205
5036,31,33,41,49,154
480,52,58,44,49,203
1640,78,61,69,53,261
2570,21,36,72,64,193
8647,56,32,42,50,180
6728,57,45,40,41,183
1395,18,31,58,43,150
3306,59,45,29,9,142
8044,37,55,70,61,223
1534,24,55,77,32,188
273,56,51,52,32,191
3258,43,39,59,34,175
6259,79,53,22,49,203
1490,81,52,34,34,201
5834,56,59,46,45,206
2595,61,54,74,54,243
3747,34,22,62,10,128
2588,16,45,33,95,189
4260,63,74,67,32,236
47,39,45,56,34,174
6729,73,53,47,51,224
8121,48,39,65,38,190
8122,71,50,65,49,235
1324,58,82,48,42,230
9955,21,64,58,35,178
3975,24,54,49,57,184
9149,52,5,66,62,185
9717,61,46,67,44,218
5698,50,68,41,36,195
7690,42,41,23,41,147
5182,45,63,58,56,222
1468,66,42,59,49,216
2650,43,33,36,35,147
4541,56,54,47,65,222
7810,49,47,52,36,184
8131,31,50,59,63,203
605,68,21,70,61,220
4347,77,26,33,26,162
7581,67,26,70,65,228
8920,56,57,32,40,185
3323,49,69,39,62,219
5969,45,36,57,66,204
3658,72,36,32,39,179
1831,11,39,66,25,141
5692,39,61,45,52,197
1272,17,61,27,49,154
6982,33,52,56,16,157
5299,51,22,45,49,167
378,39,74,48,45,206
7919,70,22,61,34,187
5426,54,46,45,58,203
7782,22,42,44,84,192
4649,78,36,62,41,217
9743,59,18,55,50,182
6354,40,38,48,41,167
6672,75,35,55,62,227
3426,54,38,34,51,177
5633,67,40,42,49,198
9803,65,56,32,26,179
7370,53,60,25,65,203
5480,84,38,53,48,223
6267,50,52,30,44,176
993,59,62,31,47,199
5799,45,61,43,39,188
4814,35,75,58,38,206
6021,79,56,83,50,268
3523,29,59,49,53,190
1229,67,80,56,61,264
3993,18,82,43,39,182
879,44,46,58,45,193
989,39,58,47,57,201
8998,18,56,69,23,166
2267,9,45,30,30,114
4470,60,64,36,47,207
6803,35,42,53,59,189
4536,58,70,51,80,259
3533,50,40,22,64,176
2317,40,41,66,80,227
6556,33,51,48,54,186
3355,57,57,47,42,203
8992,47,26,23,54,150
1214,31,42,44,50,167
868,62,52,39,65,218
1255,46,43,65,51,205
5052,57,18,35,59,169
9138,36,91,54,74,255
8088,75,23,71,44,213
9296,49,67,61,45,222
1076,51,38,63,40,192
5618,50,42,79,29,200
3058,52,68,60,59,239
2394,43,49,52,34,178
6839,50,80,48,46,224
394,54,41,38,24,157
4066,29,42,50,46,167
1321,67,55,81,33,236
996,38,27,76,59,200
4575,69,79,43,44,235
3488,51,49,46,31,177
7030,39,49,35,68,191
2269,27,40,56,47,170
8226,59,43,26,50,178
5772,68,44,79,47,238
469,57,53,24,68,202
3054,46,42,53,2,143
5916,66,56,58,12,192
8283,71,70,66,42,249
8916,45,34,44,67,190
1715,34,44,30,46,154
260,43,40,23,52,158
296,49,33,33,33,148
5397,64,51,28,52,195
787,60,33,33,53,179
8580,64,40,41,50,195
5085,33,46,29,53,161
9448,83,23,59,30,195
1773,39,74,56,44,213
5931,61,45,31,51,188
9842,42,78,36,43,199
3409,42,47,46,35,170
373,80,19,57,56,212
5154,50,41,20,50,161
8123,56,17,59,56,188
5781,38,43,35,41,157
3923,58,15,34,28,135
137,42,21,74,74,211
3719,64,58,58,30,210
6044,36,60,48,31,175
6149,64,55,36,63,218
4577,43,58,33,60,194
9723,69,21,48,50,188
6988,21,50,49,81,201
6723,33,58,73,54,218
6951,36,61,36,59,192
6221,53,52,69,63,237
4113,59,22,39,46,166
5345,42,69,47,51,209
8126,37,38,52,51,178
7758,32,50,60,24,166
2437,68,44,50,81,243
299,57,51,73,52,233
992,60,35,33,49,177
4101,69,69,57,50,245
6805,57,36,55,52,200
603,56,63,28,53,200
8767,34,55,45,69,203
2597,36,38,46,81,201
4695,61,39,61,51,212
8188,48,38,46,46,178
834,53,48,62,39,202
8481,81,52,55,47,235
7122,77,42,59,68,246
6481,26,41,55,49,171
9505,24,18,34,46,122
5771,59,22,55,36,172
5356,50,70,44,48,212
6789,26,47,55,65,193
3605,60,58,40,24,182
2613,42,45,82,53,222
6455,50,25,51,81,207
78,76,44,46,35,201
8032,41,43,59,68,211
7429,30,53,43,85,211
5798,34,42,69,66,211
4626,33,43,38,54,168
8454,27,52,21,57,157
6675,35,13,31,54,133
5046,36,68,41,40,185
4301,62,44,53,63,222
6088,55,72,37,46,210
426,48,65,30,57,200
9118,46,53,85,40,224
1406,44,79,31,23,177
4842,57,48,24,0,129
1327,54,49,76,47,226
6257,72,54,68,50,244
7318,29,43,49,73,194
7616,56,38,52,63,209
3191,43,41,59,75,218
9987,59,59,41,51,210
463,52,62,34,51,199
1310,97,65,47,46,255
1620,41,52,56,50,199
5607,61,44,28,19,152
3050,42,24,40,40,146
641,60,69,65,41,235
1222,34,59,46,37,176
3684,31,28,56,52,167
3819,53,57,62,50,222
5015,49,50,74,41,214
3404,52,57,51,30,190
3356,14,42,41,57,154
3086,60,67,54,21,202
212,44,62,51,72,229
3565,50,55,30,53,188
5191,28,42,51,37,158
6192,48,33,27,48,156
1088,77,34,64,38,213
975,66,64,70,66,266
1247,6,72,36,43,157
1096,46,25,47,3,121
8244,61,22,36,57,176
7416,58,11,45,64,178
4754,71,77,46,16,210
2901,35,34,21,80,170
9643,9,70,54,44,177
5133,38,42,38,53,171
8829,47,20,51,47,165
7850,2,44,57,75,178
3457,38,50,34,67,189
9659,39,27,34,74,174
7488,69,33,24,28,154
224,55,26,29,24,134
1847,80,35,58,33,206
6031,60,24,67,39,190
2931,39,60,30,31,160
5668,41,46,0,37,124
6251,26,46,68,69,209
8268,37,21,61,65,184
4692,29,24,42,53,148
3813,70,63,55,49,237
2608,10,15,66,23,114
3247,40,47,22,32,141
6300,59,42,50,38,189
9148,62,25,58,55,200
7624,26,34,67,44,171
7787,29,68,56,55,208
869,35,48,39,74,196
498,44,62,61,19,186
6677,29,59,66,51,205
4764,60,52,60,67,239
980,60,50,75,71,256
2020,49,49,41,69,208
6970,75,67,59,73,274
4429,25,64,29,53,171
3834,54,72,59,14,199
7083,49,66,47,28,190
2130,60,68,24,19,171
9896,90,45,39,39,213
9048,67,25,32,79,203
1572,30,59,62,52,203
4844,47,44,51,37,179
5396,37,74,54,47,212
6698,67,60,48,60,235
1376,54,20,46,61,181
4153,42,53,78,63,236
1604,24,65,66,45,200
2602,40,55,57,33,185
3260,57,70,52,37,216
7078,47,76,72,53,248
6162,32,61,43,35,171
3608,24,39,30,46,139
3310,85,32,57,38,212
1897,53,52,41,41,187
2838,28,39,22,52,141
1249,76,82,80,67,305
4306,51,51,46,23,171
220,28,35,45,55,163
7365,61,45,56,57,219
316,35,22,38,48,143
9119,41,40,90,39,210
9476,51,47,46,35,179
2758,48,54,44,38,184
6745,63,33,46,23,165
5331,60,71,21,42,194
6270,64,37,56,40,197
9860,45,63,72,65,245
2918,48,50,49,36,183
4360,51,58,54,47,210
8412,23,36,60,49,168
5076,57,60,52,51,220
7855,54,30,53,40,177
4912,63,44,52,36,195
8168,36,49,29,61,175
8050,42,39,75,48,204
6605,31,43,68,45,187
8924,82,54,30,50,216
3841,26,45,38,61,170
4864,51,70,50,39,210
9205,54,54,57,63,228
6856,36,48,61,31,176
278,48,29,18,52,147
883,31,23,23,48,125
8739,36,65,57,49,207
3002,40,56,47,74,217
5577,71,51,36,16,174
6179,41,21,43,50,155
2897,50,63,50,70,233
7196,38,23,42,55,158
9940,65,27,26,76,194
9784,66,42,49,42,199
5784,56,57,72,46,231
2815,58,35,57,66,216
3114,48,46,34,57,185
24,61,47,92,35,235
8311,66,48,43,59,216
3248,54,11,39,80,184
4288,14,60,73,45,192
6655,32,82,36,43,193
6621,36,31,62,62,191
5996,16,42,5,55,118
4302,84,84,64,58,290
6197,47,49,49,65,210
8464,45,88,56,58,247
5343,53,14,57,72,196
3295,59,36,54,77,226
8008,38,99,45,65,247
4727,35,50,67,73,225
5490,41,72,52,65,230
9869,90,38,32,0,160
6427,61,35,63,55,214
3097,56,47,64,69,236
1219,60,35,47,64,206
8080,21,65,39,37,162
2286,46,28,57,61,192
5440,95,36,53,27,211
9060,21,63,46,41,171
6760,42,39,41,71,193
676,24,30,76,46,176
9548,33,47,78,64,222
2995,54,73,23,41,191
4516,67,56,39,46,208
5204,46,64,52,45,207
1757,33,62,59,38,192
8885,56,65,20,41,182
5942,54,61,49,60,224
5700,46,69,76,70,261
6378,90,56,32,47,225
739,40,56,35,70,201
268,35,52,55,8,150
4062,45,73,31,19,168
4115,55,62,59,53,229
3390,62,37,58,31,188
7593,48,59,27,72,206
7018,51,46,29,30,156
5708,41,50,32,52,175
5845,82,62,44,34,222
8559,46,45,42,46,179
6473,32,30,47,61,170
5867,56,29,79,41,205
3781,83,57,35,80,255
3376,37,26,31,44,138
6454,42,35,58,48,183
2023,58,50,35,66,209
8987,64,57,23,62,206
2071,66,40,21,38,165
3575,55,40,33,82,210
7520,49,43,91,60,243
7173,32,14,68,47,161
2773,59,42,59,27,187
5146,38,61,44,59,202
259,76,25,34,43,178
4522,66,27,64,55,212
8252,37,59,71,44,211
2604,44,43,45,69,201
6014,76,46,20,53,195
6653,36,27,61,66,190
9094,56,54,61,53,224
4806,50,63,26,73,212
3292,31,17,29,19,96
1759,52,35,26,37,150
3209,58,51,75,54,238
5769,61,61,44,55,221
2582,38,47,50,46,181
2299,53,70,58,42,223
1628,19,67,48,53,187
2934,64,72,57,72,265
8106,32,42,68,56,198
1040,31,46,45,44,166
5392,32,62,53,54,201
8800,66,40,88,33,227
9269,40,30,28,52,150
6842,66,58,40,25,189
385,48,47,48,57,200
9081,65,51,56,53,225
8293,52,37,85,65,239
8344,46,60,91,42,239
1127,60,47,47,37,191
6710,45,46,36,35,162
1485,65,37,63,51,216
356,18,52,66,50,186
6256,45,43,56,35,179
3729,59,34,39,40,172
8614,80,48,44,52,224
6181,33,35,46,45,159
9216,48,36,64,76,224
4157,59,45,26,29,159
2108,64,29,66,46,205
2095,26,82,42,46,196
419,38,58,40,48,184
2418,26,37,22,69,154
4945,35,75,51,42,203
1518,37,65,43,58,203
6583,36,79,27,30,172
6368,73,35,31,49,188
9494,39,67,36,50,192
3421,62,72,51,80,265
2752,49,33,39,65,186
1755,34,34,36,64,168
9371,36,37,57,74,204
8353,51,62,40,57,210
3778,42,74,66,37,219
1857,63,63,31,56,213
245,53,67,59,50,229
7077,29,73,43,42,187
6053,50,45,35,51,181
8831,49,41,79,58,227
7606,36,53,21,56,166
9085,73,63,79,22,237
639,27,72,64,78,241
5142,42,50,70,35,197
6942,61,43,90,44,238
6451,47,44,33,38,162
5588,48,60,33,78,219
5198,52,55,38,73,218
7645,62,31,46,56,195
4712,64,62,54,58,238
8672,33,38,43,47,161
407,30,37,64,16,147
3176,40,53,82,60,235
2609,61,42,40,32,175
9567,66,54,56,50,226
2859,47,76,19,42,184
3414,52,63,55,17,187
8503,56,42,44,58,200
4723,51,52,42,37,182
6806,40,75,55,46,216
7253,42,35,67,57,201
2878,38,55,61,57,211
2409,34,24,27,78,163
8915,83,43,64,64,254
396,49,50,33,37,169
947,51,43,37,19,150
9654,51,58,53,39,201
1573,70,53,53,47,223
9237,52,79,61,52,244
3724,45,63,51,67,226
7309,33,48,52,71,204
721,50,48,29,41,168
1975,24,57,46,57,184
1023,56,40,40,54,190
2387,48,64,76,55,243
775,74,67,58,58,257
5405,85,58,56,64,263
6808,44,8,54,50,156
7892,39,56,45,55,195
4696,20,61,52,83,216
9386,21,47,65,71,204
2521,70,64,13,54,201
4202,53,46,54,65,218
4990,30,63,48,43,184
1675,53,50,51,35,189
7452,64,47,43,79,233
8379,57,40,57,65,219
3133,68,63,51,68,250
5506,50,60,64,55,229
7900,48,73,44,56,221
764,45,65,56,7,173
562,62,80,39,44,225
9243,78,36,8,42,164
7874,38,64,32,62,196
8307,41,40,85,51,217
4103,47,47,59,50,203
9551,48,37,27,38,150
7302,49,62,57,52,220
9462,27,52,59,27,165
9871,31,55,28,43,157
8104,66,52,69,27,214
8967,49,62,82,47,240
7436,64,22,48,51,185
3370,56,58,38,22,174
1791,48,62,60,66,236
3508,54,49,53,26,182
651,35,48,50,53,186
7346,24,53,51,26,154
4443,42,45,44,67,198
7412,42,27,68,28,165
283,48,73,71,32,224
5314,47,59,28,36,170
9334,17,14,64,53,148
8681,40,59,39,45,183
6228,40,58,29,46,173
7,49,43,35,59,186
7637,35,56,65,50,206
766,29,35,55,52,171
6384,79,11,41,53,184
9400,34,55,46,77,212
5812,22,62,24,32,140
389,37,40,53,66,196
7701,51,56,51,43,201
5301,51,45,38,43,177
8115,54,59,52,22,187
6317,99,47,49,61,256
6933,28,39,72,50,189
6164,49,68,40,39,196
4667,51,38,25,68,182
4145,53,51,56,33,193
9276,47,79,45,53,224
2745,42,67,61,57,227
4111,25,39,43,44,151
5880,36,72,52,71,231
315,41,35,48,65,189
6514,59,56,54,51,220
1071,97,23,60,56,236
2728,30,46,50,50,176
7109,61,38,57,50,206
5017,48,44,53,61,206
5368,58,23,51,61,193
3520,55,45,34,37,171
4147,49,36,47,41,173
1613,47,65,70,88,270
5202,70,73,18,46,207
9934,74,23,57,56,210
5971,43,49,65,58,215
7135,48,38,45,53,184
8759,80,35,39,55,209
4873,58,47,19,57,181
120,34,60,56,45,195
1546,59,63,44,57,223
3626,67,54,54,71,246
822,48,39,15,38,140
7871,44,36,19,66,165
4906,66,55,62,52,235
9831,60,55,53,36,204
927,62,53,71,49,235
7306,47,53,39,72,211
5644,6,65,44,22,137
4086,53,64,63,55,235
633,52,35,27,39,153
6408,50,56,86,26,218
2921,41,42,64,76,223
4716,42,62,47,31,182
8989,66,17,81,70,234
4230,18,32,69,50,169
7989,37,30,37,51,155
2688,49,70,53,44,216
1777,46,67,60,62,235
7962,78,81,39,64,262
7626,24,43,54,52,173
8242,56,59,21,22,158
3268,47,36,42,43,168
494,51,33,62,18,164
7952,59,15,51,44,169
7667,66,68,61,50,245
4813,64,34,26,54,178
8959,48,32,36,45,161
59,54,58,45,30,187
482,70,77,41,45,233
1735,53,59,53,34,199
422,70,65,34,35,204
5325,37,77,61,49,224
2700,23,43,54,67,187
8459,51,34,47,67,199
7442,46,46,78,32,202
7564,52,35,41,46,174
9451,65,42,44,64,215
6571,48,43,28,54,173
97,34,36,59,50,179
6981,43,56,32,32,163
9660,58,36,44,66,204
5800,38,47,56,52,193
5669,28,52,61,53,194
3926,86,54,47,15,202
8540,13,61,48,33,155
7736,31,43,53,36,163
5610,57,37,41,8,143
5271,36,66,31,66,199
8761,48,43,60,43,194
4586,6,60,31,42,139
4339,53,42,70,42,207
1949,32,64,55,35,186
1304,57,68,59,58,242
7544,40,45,27,32,144
395,67,60,60,51,238
3045,44,37,54,17,152
829,74,33,73,68,248
5695,35,36,43,73,187
8932,54,42,47,91,234
6240,55,47,32,49,183
7313,69,23,43,33,168
3339,40,69,36,51,196
9287,56,40,44,80,220
7381,30,67,57,48,202
9234,19,30,22,33,104
5459,34,63,57,55,209
1544,27,39,63,34,163
9401,43,57,67,53,220
3516,64,59,80,76,279
9949,67,44,60,57,228
5177,36,40,60,27,163
9228,37,39,82,29,187
3462,39,58,68,52,217
3903,49,58,55,48,210
5959,54,72,39,50,215
2341,48,51,33,64,196
4562,72,53,59,68,252
8267,41,83,68,62,254
9730,68,9,56,73,206
3902,13,28,35,49,125
2943,67,40,38,38,183
4022,61,67,41,42,211
5268,77,100,75,48,300
8741,47,75,67,40,229
1712,33,81,47,24,185
6863,47,45,58,54,204
1379,21,29,56,40,146
4379,56,67,47,41,211
5871,50,62,60,65,237
8930,32,14,41,59,146
9235,43,44,59,67,213
6798,56,62,65,65,248
735,72,60,57,37,226
4524,44,59,64,22,189
3547,39,69,45,55,208
8239,52,56,74,40,222
9110,27,54,65,21,167
3731,44,51,46,29,170
4355,34,60,57,30,181
2879,53,38,44,54,189
8818,20,63,64,53,200
2222,60,59,57,41,217
5537,55,44,52,71,222
4644,75,53,60,48,236
7943,27,41,61,60,189
3757,48,54,72,26,200
5347,56,37,55,55,203
9375,27,34,43,46,150
3169,43,50,61,66,220
4300,46,29,30,48,153
4465,62,58,62,46,228
106,80,66,79,42,267
826,63,30,29,62,184
9102,46,41,43,79,209
9816,38,50,27,63,178
5728,43,55,47,63,208
9526,52,55,32,41,180
6105,38,35,60,63,196
3332,45,59,38,35,177
438,68,74,36,15,193
9394,50,75,41,66,232
9223,52,69,39,67,227
9209,65,23,65,61,214
7515,60,50,51,56,217
6171,79,31,56,68,234
3431,58,55,28,46,187
4861,66,49,48,41,204
5776,72,50,48,55,225
4932,50,50,37,30,167
7972,35,83,33,45,196
5058,48,40,21,68,177
4709,56,48,73,38,215
6630,40,52,47,77,216
6287,44,68,48,61,221
3502,53,68,70,39,230
4774,31,68,25,62,186
714,82,42,35,58,217
5114,72,17,32,20,141
7153,66,66,44,41,217
5352,21,67,60,60,208
2351,46,39,85,50,220
9675,93,60,47,38,238
8487,43,67,34,45,189
1971,20,70,29,58,177
2630,69,43,57,69,238
7682,52,47,46,25,170
6163,62,66,23,73,224
6966,51,72,31,72,226
917,29,65,29,47,170
8081,70,33,58,31,192
2153,55,45,26,53,179
271,37,39,73,45,194
4748,70,35,18,78,201
9188,26,53,50,61,190
4501,29,49,54,50,182
6663,50,34,66,58,208
5600,40,61,51,23,175
7382,88,42,72,50,252
6527,60,33,43,48,184
5624,38,62,46,69,215
6398,44,43,52,37,176
4107,29,55,26,43,153
1392,60,48,71,46,225
9676,33,75,49,53,210
6504,71,68,68,53,260
5682,59,42,84,84,269
1551,61,51,58,48,218
7817,47,39,46,85,217
9609,19,69,94,30,212
2888,56,53,56,33,198
7148,62,45,46,64,217
4133,35,27,48,36,146
9015,24,34,50,41,149
2967,38,55,48,48,189
193,14,43,42,30,129
5742,48,51,59,41,199
6462,42,34,50,55,181
6350,50,62,52,65,229
2063,69,59,66,87,281
5690,35,67,63,57,222
6884,44,59,41,55,199
1274,39,38,34,73,184
8119,40,47,63,43,193
8147,63,71,68,51,253
4678,59,52,46,38,195
6370,60,51,42,24,177
4014,41,27,56,51,175
5903,38,56,58,30,182
1480,35,56,61,40,192
9556,57,23,57,37,174
5711,59,68,45,29,201
7426,73,32,31,26,162
404,57,42,3,72,174
1378,37,55,100,58,250
3822,48,4,54,56,162
578,44,54,67,27,192
616,44,76,23,35,178
4295,61,48,57,76,242
9604,59,44,60,56,219
9971,35,47,68,53,203
7502,74,53,58,46,231
8956,33,64,43,57,197
281,37,56,25,73,191
5275,60,49,33,62,204
7583,33,21,59,57,170
7550,61,31,66,9,167
2652,37,31,50,53,171
5143,68,54,53,55,230
507,55,41,54,47,197
4964,84,64,26,40,214
4789,75,52,58,52,237
591,70,56,38,48,212
8844,53,21,47,28,149
7266,29,42,54,43,168
6388,60,68,46,40,214
7625,58,61,62,62,243
3687,61,21,29,53,164
4832,37,42,36,53,168
3758,69,48,63,59,239
4971,36,49,41,57,183
3945,36,51,63,47,197
6704,63,36,44,64,207
974,55,77,31,31,194
3681,48,54,56,69,227
800,74,64,45,34,217
1634,43,59,56,60,218
5183,53,56,41,79,229
4880,72,47,78,35,232
8587,70,39,47,46,202
5782,88,57,82,66,293
2209,33,70,65,39,207
2533,30,42,64,64,200
8726,87,48,54,53,242
153,26,58,35,24,143
7700,56,35,50,51,192
9983,61,26,67,38,192
8250,48,61,52,64,225
4365,52,20,77,28,177
5483,75,33,15,51,174
923,15,84,43,56,198
7019,33,47,42,50,172
9587,42,27,57,37,163
5378,3,42,45,54,144
1120,51,54,16,64,185
997,42,35,36,62,175
8113,74,58,31,43,206
9772,39,4,32,65,140
8971,66,48,55,57,226
8362,54,57,58,51,220
8523,49,59,43,56,207
6463,53,37,44,78,212
4303,38,63,42,36,179
3966,32,49,55,27,163
7812,22,64,70,71,227
7246,58,62,22,26,168
3749,33,60,39,49,181
1987,0,47,41,60,148
6601,50,50,59,31,190
624,8,59,40,39,146
3080,62,86,58,69,275
7604,67,85,38,36,226
2505,22,64,29,68,183
4571,41,59,70,26,196
2548,68,23,39,60,190
6289,40,42,37,36,155
4533,44,33,61,60,198
520,37,29,64,75,205
7272,56,20,50,79,205
6349,39,70,88,44,241
4835,60,84,56,45,245
2856,48,7,90,37,182
4440,39,35,39,45,158
3816,50,52,22,36,160
9733,21,60,41,54,176
6499,58,47,53,37,195
9352,40,35,50,28,153
867,53,53,41,62,209
8156,33,55,68,28,184
7184,52,9,37,51,149
9272,56,64,8,32,160
6656,84,51,49,29,213
5102,59,79,67,44,249
2457,59,28,58,28,173
5982,32,39,56,38,165
9369,39,40,48,60,187
6524,24,67,75,34,200
9926,31,53,27,28,139
3041,54,55,37,57,203
280,66,41,58,49,214
4044,68,40,17,48,173
9168,34,50,66,49,199
9071,22,35,36,54,147
8443,31,28,55,15,129
2149,42,17,53,33,145
7004,57,32,24,43,156
4419,23,6,32,43,104
3760,73,32,45,55,205
4503,58,42,20,48,168
4783,52,65,35,51,203
1421,50,46,53,34,183
7469,49,56,37,43,185
4140,54,30,16,62,162
85,43,66,85,56,250
6433,62,39,54,51,206
9879,48,32,44,48,172
9626,50,31,53,24,158
5393,42,58,59,69,228
7312,35,44,69,50,198
2103,43,51,66,69,229
1771,30,38,36,67,171
9612,43,72,86,44,245
6565,47,31,64,47,189
2839,58,80,36,43,217
6900,68,79,54,54,255
5788,43,53,60,43,199
9930,57,60,41,80,238
5527,39,44,47,31,161
4599,18,29,49,50,146
1952,33,38,47,26,144
4737,8,42,50,37,137
491,48,50,39,38,175
5687,47,48,52,35,182
6000,40,59,72,61,232
9109,52,51,79,47,229
6480,66,38,34,31,169
7633,59,60,64,54,237
6537,28,48,42,70,188
2776,36,52,34,53,175
5805,56,38,42,56,192
1119,43,28,59,61,191
4249,79,64,50,38,231
2785,49,48,70,35,202
1574,39,72,52,32,195
3378,77,43,41,75,236
6976,32,43,76,53,204
2854,35,84,45,67,231
3230,27,45,70,73,215
3282,40,53,66,44,203
5941,12,47,67,38,164
8556,61,58,56,55,230
6927,71,49,35,70,225
1090,28,53,29,70,180
8803,55,60,43,38,196
2266,59,57,59,46,221
9046,78,38,25,58,199
8265,46,62,57,86,251
6262,58,64,24,53,199
2523,54,62,50,30,196
2146,38,51,65,59,213
4573,37,70,44,44,195
2621,69,40,70,69,248
3401,46,59,25,50,180
4212,43,53,46,34,176
4290,39,22,39,63,163
4180,16,54,78,45,193
3677,67,42,36,29,174
9305,50,72,60,49,231
9738,41,58,56,73,228
6476,72,79,29,57,237
7186,41,37,51,48,177
847,31,44,48,18,141
895,7,39,41,44,131
8371,72,55,59,45,231
7105,31,55,52,70,208
82,34,54,47,76,211
7440,20,48,67,50,185
9861,34,35,33,52,154
3872,36,47,58,35,176
8328,37,21,57,50,165
1047,65,59,52,63,239
3908,23,48,66,71,208
8093,61,50,45,41,197
6254,45,74,51,36,206
458,86,38,40,47,211
6411,51,55,61,63,230
1516,65,48,59,54,226
2841,28,29,58,35,150
1151,43,39,64,52,198
2302,52,48,31,48,179
726,49,41,33,73,196
1751,57,67,48,56,228
550,42,34,68,65,209
499,54,31,43,69,197
8330,60,31,37,59,187
7357,48,47,43,44,182
169,58,69,38,58,223
4983,46,71,26,45,188
6833,37,85,55,60,237
5134,94,23,53,61,231
885,63,59,38,20,180
2636,60,64,2,69,195
2105,41,32,56,52,181
655,23,25,28,37,113
1060,49,44,60,61,214
8514,41,65,50,57,213
3144,33,44,55,16,148
2736,57,48,32,48,185
5938,13,29,74,29,145
6859,10,60,55,71,196
7685,66,82,75,75,298
8621,50,39,74,68,231
4671,44,53,38,55,190
744,80,23,57,45,205
6079,56,44,43,56,199
5164,28,78,32,77,215
7904,47,30,37,67,181
6638,38,48,39,17,142
1586,15,56,60,82,213
1025,25,44,35,45,149
642,57,68,79,54,258
9239,39,20,29,45,133
6567,32,64,50,79,225
9822,39,51,60,62,212
5802,55,29,49,47,180
1507,43,49,32,65,189
8338,45,63,46,47,201
8838,41,30,58,50,179
2471,74,60,34,79,247
1332,28,66,11,39,144
3256,59,24,62,24,169
2557,31,23,68,42,164
8392,18,70,60,67,215
6060,47,45,51,25,168
6770,56,36,81,31,204
1940,61,55,76,48,240
6453,23,68,51,49,191
1005,33,61,42,32,168
3859,49,63,27,29,168
9482,47,57,76,61,241
3621,17,42,26,38,123
7790,47,32,63,55,197
3177,52,48,33,46,179
8291,56,54,10,69,189
3785,68,36,61,68,233
1552,34,62,39,83,218
3837,47,44,77,32,200
548,58,57,36,50,201
269,44,43,49,80,216
2401,64,66,49,64,243
8256,63,49,41,57,210
6241,54,43,76,38,211
4376,29,55,59,55,198
4074,49,70,58,35,212
9470,48,26,65,55,194
9198,50,68,51,33,202
9621,64,40,64,90,258
1320,59,61,65,62,247
9466,74,52,64,36,226
9184,42,23,96,26,187
2612,57,64,53,54,228
48,57,49,28,73,207
5606,26,51,14,60,151
1055,42,72,48,37,199
2997,54,87,39,46,226
3895,26,52,29,45,152
9180,60,49,47,63,219
1038,55,71,31,28,185
750,55,69,47,76,247
1128,40,35,73,60,208
2657,63,56,80,63,262
9918,39,30,56,90,215
8210,34,64,38,42,178
8475,37,48,82,55,222
1456,55,84,76,45,260
403,42,56,57,58,213
914,45,50,70,71,236
3387,18,34,44,50,146
9230,45,35,21,67,168
7536,43,42,77,68,230
3023,37,5,64,68,174
1211,72,52,44,42,210
2805,75,60,31,53,219
5447,50,59,20,71,200
139,76,59,39,44,218
1461,62,28,35,22,147
4004,55,46,60,66,227
4279,51,69,45,52,217
9187,44,56,45,84,229
4268,24,49,84,48,205
9199,63,70,58,32,223
4138,36,9,72,53,170
9997,59,58,77,23,217
8053,64,15,59,51,189
3246,73,34,47,73,227
628,30,63,22,44,159
8082,48,60,34,41,183
4061,46,67,47,29,189
4484,65,71,35,43,214
8960,45,47,60,67,219
9755,69,51,64,45,229
9520,65,67,50,62,244
5462,66,70,65,51,252
3069,30,26,47,20,123
3261,72,21,37,45,175
1306,24,56,57,74,211
8907,70,77,54,69,270
7590,58,61,32,24,175
1776,35,51,41,62,189
1227,44,80,15,67,206
8997,46,64,70,58,238
8921,38,81,63,53,235
3673,65,36,29,55,185
533,72,55,62,47,236
8796,71,58,60,36,225
3776,57,34,64,56,211
7341,33,45,29,70,177
1950,55,33,40,26,154
9478,54,30,57,30,171
9633,57,35,81,47,220
6464,56,29,45,52,182
3071,36,51,41,63,191
3398,46,54,59,70,229
7731,54,30,73,76,233
770,54,50,46,83,233
5855,47,58,24,45,174
3244,34,61,86,45,226
2929,48,73,54,13,188
2287,88,66,50,30,234
6862,49,59,60,56,224
2750,61,55,41,48,205
4545,36,64,57,55,212
6902,55,43,57,48,203
427,40,47,82,45,214
3250,46,49,61,47,203
2870,20,51,46,39,156
6080,66,40,70,100,276
3099,32,59,46,41,178
7005,53,55,58,47,213
197,71,25,70,46,212
4050,64,53,18,64,199
7809,55,38,54,32,179
1995,52,72,54,50,228
8925,37,59,53,68,217
5330,48,49,72,45,214
8074,45,45,39,50,179
2715,44,34,54,55,187
306,10,74,44,51,179
3571,60,89,41,60,250
8264,40,59,64,48,211
5970,16,35,69,28,148
168,53,50,52,26,181
9975,59,60,52,44,215
2376,42,58,46,64,210
7268,60,38,39,52,189
5469,64,62,39,31,196
7378,34,63,61,32,190
9140,72,87,35,46,240
295,39,48,39,34,160
7808,34,34,58,55,181
9658,50,29,59,53,191
5517,30,55,21,61,167
3408,46,28,26,43,143
4181,67,32,25,48,172
7579,67,49,27,63,206
4130,60,45,43,38,186
2391,53,56,42,39,190
5030,15,57,34,51,157
1030,55,36,46,54,191
5369,47,75,62,32,216
8177,75,47,44,43,209
6049,71,67,64,55,257
6508,41,52,49,52,194
5988,70,33,65,65,233
8577,32,42,50,19,143
6098,53,67,47,15,182
5409,53,27,48,22,150
7636,44,33,50,41,168
5886,57,29,59,19,164
6067,50,35,48,65,198
9731,41,48,58,8,155
1411,51,73,35,63,222
4961,74,53,33,66,226
4207,47,27,54,52,180
7129,47,48,61,68,224
1957,36,44,40,64,184
6258,43,49,45,53,190
9758,42,32,50,85,209
5993,48,42,53,43,186
1269,29,36,45,37,147
3595,77,43,42,76,238
6637,63,48,86,80,277
9853,60,63,38,50,211
4308,40,27,49,37,153
2306,49,95,49,44,237
7290,37,67,72,54,230
6882,35,54,49,80,218
2385,78,41,68,23,210
9055,35,55,53,48,191
5895,41,59,64,50,214
8099,29,28,55,38,150
4053,47,57,47,39,190
6996,47,36,47,52,182
5621,59,43,43,27,172
3109,29,9,49,42,129
2578,60,80,62,77,279
2592,38,23,54,63,178
8680,58,43,46,43,190
8679,35,34,67,64,200
8413,78,73,83,46,280
3297,41,13,25,51,130
2733,55,69,55,37,216
6374,44,70,45,41,200
6140,44,72,39,40,195
1529,25,52,56,62,195
3005,38,46,4,32,120
6414,53,46,54,47,200
4613,40,34,65,67,206
4395,70,73,28,62,233
8329,41,51,63,34,189
1094,24,25,76,47,172
1362,52,57,50,45,204
1437,35,89,48,46,218
1317,67,34,69,50,220
2914,57,40,27,35,159
878,81,44,52,32,209
2970,48,29,71,32,180
3891,32,58,52,60,202
1294,71,32,56,53,212
4280,48,40,49,61,198
3581,47,30,23,52,152
1400,71,47,33,42,193
6587,60,91,48,57,256
6505,39,55,58,69,221
2288,81,47,17,72,217
1960,66,89,57,13,225
452,77,43,76,55,251
2907,55,38,14,51,158
1752,66,36,20,43,165
4250,36,33,34,51,154
8103,63,42,63,53,221
3931,67,50,68,61,246
5317,53,57,62,58,230
7720,42,43,61,52,198
6973,62,54,18,46,180
4598,75,46,47,59,227
6904,74,45,71,40,230
3138,23,63,41,32,159
5817,46,67,71,40,224
1145,45,86,37,53,221
8073,58,64,73,53,248
5329,44,47,48,53,192
3959,49,38,72,51,210
9273,45,45,17,23,130
5312,38,42,56,63,199
5372,38,51,38,62,189
4204,49,66,41,21,177
1270,57,47,40,45,189
1689,26,64,74,32,196
1563,59,23,77,57,216
1328,33,19,54,71,177
8281,27,38,49,62,176
2357,48,44,53,62,207
9175,52,42,30,37,161
414,45,30,43,74,192
5037,81,52,59,58,250
6486,68,74,34,47,223
8887,47,68,37,70,222
1081,63,59,26,31,179
279,47,35,45,32,159
9049,43,61,66,71,241
9823,59,59,30,46,194
4159,73,29,67,39,208
9366,23,37,41,44,145
192,28,18,43,40,129
2692,44,38,74,58,214
9546,48,28,43,46,165
5422,49,50,42,60,201
6515,59,75,54,48,236
5539,66,46,52,55,219
6577,65,66,41,43,215
2060,69,48,32,86,235
4256,50,24,37,48,159
6949,16,55,29,71,171
7654,49,41,68,22,180
2598,53,58,50,58,219
1,40,53,52,59,204
7534,36,30,40,53,159
4024,13,29,73,55,170
1285,82,75,63,52,272
1253,46,56,38,89,229
1098,38,44,42,55,179
2933,56,32,65,2,155
2944,26,49,55,46,176
9041,54,66,67,54,241
2495,54,38,61,84,237
9555,69,60,59,23,211
5467,43,62,60,34,199
6906,63,77,50,26,216
9465,33,46,75,45,199
3128,62,51,60,59,232
1283,31,72,59,58,220
3518,55,33,45,36,169
7140,51,53,65,78,247
4772,65,40,23,73,201
6305,43,71,53,52,219
5563,46,63,51,57,217
1496,60,72,48,37,217
9902,57,42,41,38,178
6984,31,57,47,39,174
54,40,54,61,47,202
881,63,32,69,34,198
8558,41,36,45,56,178
6429,71,22,64,74,231
1981,53,71,30,58,212
1964,51,33,36,48,168
1369,41,43,72,46,202
476,60,80,39,39,218
3433,57,60,44,58,219
3949,49,63,37,26,175
1770,71,71,57,58,257
2201,29,48,49,64,190
7157,42,49,54,42,187
2978,51,49,42,20,162
4009,52,48,40,50,190
3884,70,56,49,69,244
7795,64,57,63,47,231
2309,54,37,56,70,217
1826,37,60,10,66,173
3345,19,38,28,60,145
5200,30,45,47,64,186
3073,49,61,40,64,214
5411,38,54,28,57,177
8327,64,55,52,52,223
9130,47,51,76,52,226
8364,40,48,50,84,222
5223,70,41,65,51,227
4889,81,29,51,50,211
2707,63,38,39,79,219
1710,36,22,52,37,147
748,66,56,55,45,222
2342,53,60,45,36,194
8441,53,57,50,63,223
9011,53,54,61,55,223
100,71,42,53,59,225
3800,64,39,59,60,222
8914,29,66,71,83,249
9506,63,63,48,73,247
9336,22,70,29,44,165
1651,52,61,47,31,191
6416,43,64,67,56,230
8651,42,45,52,70,209
9910,56,23,39,48,166
4289,52,58,46,75,231
6035,78,68,38,23,207
7599,36,68,58,54,216
1584,26,48,37,57,168
9000,39,21,68,21,149
2753,54,57,37,48,196
7277,79,66,41,63,249
3839,31,59,77,44,211
2382,65,50,58,63,236
2115,47,51,68,60,226
6346,36,47,34,47,164
1721,64,47,48,61,220
9538,54,63,42,46,205
6907,61,57,70,85,273
3245,72,43,38,6,159
1004,51,53,37,28,169
2284,49,52,39,57,197
1803,41,52,53,53,199
1215,41,52,50,56,199
9936,54,33,85,67,239
933,83,48,51,58,240
5881,52,43,53,47,195
5567,51,42,50,54,197
341,35,59,29,39,162
9335,49,73,22,43,187
142,33,51,29,60,173
7676,62,38,56,40,196
9558,52,31,51,34,168
9615,26,3,58,53,140
5529,24,18,45,47,134
6338,32,25,72,62,191
8539,57,54,37,55,203
5892,47,55,49,21,172
2830,48,39,88,27,202
8383,39,38,57,30,164
6301,69,50,39,67,225
4492,28,54,66,47,195
2109,87,23,28,53,191
5474,45,60,55,41,201
7739,64,68,27,60,219
8851,38,53,26,44,161
110,47,44,53,41,185
1493,31,38,36,31,136
2301,66,61,47,25,199
5648,71,39,45,44,199
7446,51,72,56,60,239
1326,51,30,55,38,174
544,38,28,57,45,168
159,53,40,26,64,183
7163,56,65,55,25,201
4804,38,28,36,74,176
1762,39,90,56,51,236
6012,55,47,74,61,237
1307,44,77,57,39,217
790,51,56,44,68,219
3924,62,36,84,68,250
9158,34,71,36,95,236
9959,55,64,50,73,242
9963,58,60,60,45,223
2969,29,60,65,43,197
6775,67,40,23,51,181
9387,48,66,4,43,161
6965,60,53,76,72,261
2653,45,39,45,58,187
1344,53,68,52,44,217
3012,43,69,45,69,226
1112,42,41,48,55,186
8167,37,40,60,60,197
4165,47,65,78,35,225
3589,42,54,56,45,197
6869,65,37,44,52,198
836,30,60,23,30,143
7406,66,59,50,67,242
6377,38,60,63,23,184
5497,45,39,54,50,188
590,51,27,90,83,251
6792,57,56,65,56,234
1704,44,32,74,24,174
7391,20,42,58,37,157
1483,53,41,74,70,238
3497,41,75,32,73,221
9033,29,56,58,47,190
907,56,57,65,16,194
1275,55,45,34,50,184
7967,44,55,59,26,184
2697,54,54,63,71,242
8722,49,40,18,49,156
6090,58,54,35,40,187
903,66,72,59,52,249
324,69,60,64,35,228
9473,61,21,24,51,157
864,57,31,23,34,145
2314,57,41,40,47,185
242,42,42,40,46,170
2013,42,34,39,58,173
9026,56,70,80,52,258
456,60,20,37,48,165
1557,30,52,70,58,210
5235,14,69,73,35,191
8694,41,70,39,36,186
6925,51,55,33,59,198
1377,65,85,50,63,263
5860,30,51,17,84,182
1063,19,63,26,56,164
3997,66,52,46,47,211
3318,76,55,45,69,245
4460,39,40,72,39,190
7545,42,32,54,52,180
9691,43,32,58,51,184
6784,51,65,44,53,213
3846,79,39,74,30,222
2425,51,25,18,81,175
18,58,58,57,78,251
5838,44,54,48,77,223
4402,46,53,45,53,197
8607,56,39,58,34,187
7263,48,65,43,23,179
1190,49,40,55,72,216
3852,32,18,50,48,148
4518,36,64,65,53,218
3580,46,59,48,60,213
1911,65,79,42,51,237
3357,72,59,49,71,251
6115,52,49,36,52,189
1062,65,52,35,43,195
8669,46,58,38,42,184
7400,59,66,50,68,243
5279,60,44,58,50,212
9436,47,33,61,59,200
9363,42,36,39,38,155
5344,72,34,51,70,227
6824,55,49,76,62,242
9390,54,32,65,28,179
7578,38,41,61,32,172
4759,33,41,34,54,162
4826,18,79,37,28,162
8248,43,42,60,33,178
9034,36,62,68,35,201
8764,50,57,31,51,189
2806,56,30,42,38,166
1779,53,72,59,65,249
6214,56,63,68,79,266
6095,48,65,28,55,196
5554,55,48,38,50,191
2465,27,45,35,39,146
7666,39,44,56,48,187
1997,54,36,24,20,134
3255,36,23,66,55,180
3603,70,26,37,50,183
8474,47,47,45,47,186
9636,47,61,21,60,189
5135,53,64,32,42,191
4500,29,43,36,79,187
5921,62,49,26,53,190
9468,30,75,30,35,170
1653,71,36,61,43,211
3702,39,82,33,45,199
318,53,65,35,71,224
6304,65,62,44,39,210
1010,56,70,64,40,230
5796,74,39,41,39,193
9264,65,20,25,51,161
5661,44,60,22,41,167
1314,44,67,42,39,192
9932,38,36,33,22,129
1401,51,57,8,50,166
8077,60,63,63,33,219
1443,44,57,23,40,164
3828,41,68,72,42,223
4193,53,54,51,67,225
1869,50,57,57,41,205
6243,34,68,29,44,175
7886,58,36,78,34,206
4576,45,62,63,65,235
8529,67,33,68,37,205
5502,55,30,29,43,157
3476,66,46,53,24,189
2685,51,64,41,55,211
6529,22,32,39,58,151
9885,34,54,58,28,174
8828,4,71,74,59,208
6242,30,52,41,46,169
9614,63,25,65,44,197
1999,70,61,54,49,234
798,27,47,40,31,145
7776,26,60,48,23,157
8203,54,36,48,48,186
5777,69,48,27,18,162
2631,69,26,19,36,150
5413,61,24,62,65,212
2480,46,42,59,70,217
7100,48,69,14,39,170
4611,55,52,50,62,219
777,53,37,26,53,169
615,42,63,23,50,178
4610,46,63,52,38,199
6100,59,54,68,44,225
7174,55,62,29,39,185
8089,40,31,68,37,176
3419,61,58,56,30,205
5442,26,46,54,54,180
2325,72,49,48,61,230
9108,33,70,54,16,173
371,36,52,47,42,177
4948,55,53,46,54,208
7885,20,70,26,63,179
7804,53,59,49,53,214
8988,42,44,49,44,179
6584,43,42,22,52,159
3434,46,44,58,47,195
9838,51,64,22,47,184
8613,37,39,31,30,137
6834,32,16,47,52,147
6802,39,33,64,49,185
3013,39,41,39,52,171
1232,58,55,51,36,200
4767,58,61,18,80,217
5243,66,41,77,53,237
3185,61,56,55,41,213
432,39,57,30,28,154
768,65,52,31,36,184
1104,60,24,61,40,185
7765,39,44,39,41,163
2408,39,58,24,17,138
929,40,34,38,50,162
9265,71,72,66,18,227
7117,74,59,64,35,232
7669,36,60,64,41,201
8644,30,25,62,84,201
8541,46,73,64,45,228
1037,40,72,88,83,283
8676,35,52,55,33,175
1871,51,38,59,48,196
2282,67,26,67,54,214
8234,47,48,16,36,147
1656,44,46,74,33,197
7493,53,41,65,52,211
3742,44,44,59,39,186
8879,33,51,58,47,189
7317,43,20,61,37,161
2507,43,76,24,64,207
647,19,57,57,38,171
3818,46,51,52,29,178
5320,53,41,40,36,170
1745,39,70,27,53,189
6018,45,53,24,50,172
5983,61,20,19,11,111
3652,19,41,47,78,185
6919,55,72,49,70,246
6952,48,58,64,60,230
5510,56,39,54,29,178
6851,87,52,57,57,253
6746,64,53,56,49,222
7773,33,71,56,60,220
9584,44,63,54,78,239
2384,75,23,44,31,173
9602,28,33,78,33,172
4538,53,38,51,26,168
2128,46,28,34,28,136
7484,59,59,60,50,228
804,40,56,53,51,200
5152,58,42,48,48,196
8446,84,57,64,40,245
2489,78,52,70,38,238
5376,38,45,14,81,178
9405,40,91,79,37,247
9059,68,58,44,58,228
6778,43,16,55,54,168
5900,54,44,51,27,176
9681,25,51,26,30,132
8560,33,51,47,38,169
1641,62,56,27,39,184
8530,58,41,54,51,204
6056,35,42,51,69,197
1404,47,36,55,31,169
9942,69,72,22,57,220
7086,49,61,57,39,206
3174,62,41,38,49,190
1020,41,95,75,39,250
6668,48,93,34,29,204
1353,52,70,70,56,248
6948,43,42,40,57,182
3825,49,35,20,34,138
1929,55,10,35,40,140
1790,46,62,66,61,235
233,44,59,85,43,231
7451,32,21,44,46,143
2705,47,45,20,51,163
5789,13,46,52,51,162
3740,38,72,61,17,188
6941,42,71,51,41,205
704,43,51,65,57,216
9192,38,41,76,48,203
5861,40,40,35,38,153
4952,10,51,35,46,142
6645,41,48,89,55,233
3952,20,29,34,34,117
6386,74,9,59,43,185
7876,60,56,100,52,268
7549,63,24,66,33,186
370,39,35,68,46,188
1189,35,18,32,64,149
7551,57,68,48,45,218
9277,39,90,29,39,197
5987,41,23,73,51,188
1009,59,49,35,52,195
512,24,17,45,49,135
7614,36,53,32,42,163
2826,76,63,41,43,223
9711,60,58,50,85,253
2664,35,45,51,38,169
5647,22,57,46,65,190
9127,67,37,46,79,229
3024,57,79,45,22,203
4048,48,49,37,64,198
9923,22,51,42,52,167
5464,27,49,44,68,188
784,43,58,61,65,227
4819,17,63,72,71,223
3179,33,45,36,50,164
5894,56,47,53,90,246
4984,76,57,41,33,207
334,42,35,30,72,179
9554,54,50,68,80,252
7643,54,31,39,76,200
9077,67,48,72,75,262
6793,63,67,63,52,245
7971,60,50,42,56,208
8494,43,51,39,31,164
3510,44,48,47,65,204
876,26,84,68,49,227
7142,66,33,38,64,201
6687,56,49,50,62,217
9819,22,20,41,53,136
5404,17,70,54,38,179
1491,23,57,26,65,171
3521,66,38,65,48,217
7603,56,36,72,49,213
6073,47,47,38,54,186
8578,24,83,47,51,205
1536,19,63,58,52,192
3984,65,61,24,41,191
8692,42,42,40,60,184
8602,37,73,52,47,209
2712,18,57,66,49,190
8912,57,36,27,14,134
8254,58,45,84,47,234
5646,41,66,69,75,251
6026,44,22,53,49,168
9608,76,69,36,41,222
8748,57,36,58,21,172
3939,45,61,50,44,200
9112,48,63,44,70,225
9096,25,37,37,66,165
7248,54,72,64,39,229
8453,67,79,74,54,274
943,56,55,66,89,266
6351,13,70,52,72,207
1575,29,54,26,46,155
606,68,51,51,47,217
8878,66,47,26,32,171
5865,64,61,42,43,210
9231,56,48,38,54,196
7771,50,42,64,52,208
5505,45,43,47,41,176
9027,59,45,38,60,202
5727,65,57,65,46,233
675,38,52,56,61,207
7726,60,50,28,45,183
763,34,21,57,65,177
7085,54,35,85,27,201
8750,69,39,40,46,194
4617,61,56,46,64,227
3636,39,48,54,28,169
4054,45,30,79,86,240
9227,36,45,32,35,148
2799,63,42,69,63,237
5139,78,72,79,42,271
8420,77,29,59,57,222
6782,49,62,54,62,227
698,85,77,34,59,255
5696,44,52,75,60,231
2731,78,38,31,57,204
352,71,65,34,81,251
8316,66,80,46,100,292
2184,54,44,69,53,220
2373,34,46,43,28,151
4770,54,61,31,42,188
9613,41,82,53,51,227
4092,53,51,39,49,192
2640,41,62,65,24,192
6980,33,56,84,57,230
5759,65,47,61,24,197
3353,76,65,62,63,266
7463,38,57,57,71,223
5888,18,82,38,54,192
8640,59,92,27,58,236
2361,48,83,68,33,232
6470,51,83,40,53,227
2827,31,53,66,46,196
4731,72,42,38,53,205
5825,47,51,37,54,189
5948,76,51,40,65,232
6946,70,61,28,61,220
3014,55,54,48,46,203
6715,51,42,58,45,196
7519,60,55,47,69,231
2928,61,44,42,30,177
1186,47,55,46,41,189
9274,39,45,56,21,161
3300,49,49,63,37,198
7533,48,31,38,27,144
5258,65,37,57,47,206
6485,58,60,71,38,227
127,49,51,80,43,223
4410,48,45,65,64,222
9351,74,40,29,50,193
8958,70,55,38,43,206
5586,46,56,55,69,226
1335,38,44,46,33,161
1797,43,70,96,52,261
9536,22,55,42,43,162
8745,49,41,54,31,175
6614,57,61,84,58,260
783,47,54,60,48,209
2368,46,39,22,27,134
7751,58,59,23,43,183
796,55,65,42,61,223
6598,60,70,73,51,254
5212,83,68,33,75,259
4401,22,63,32,52,169
2872,60,31,65,52,208
4816,43,53,45,63,204
6897,35,72,38,68,213
2846,24,18,45,63,150
6355,47,69,44,42,202
6194,66,47,62,9,184
9524,39,48,65,41,193
1236,65,50,45,73,233
682,11,55,29,55,150
3372,50,43,44,17,154
8298,75,13,52,45,185
857,59,53,46,44,202
5540,59,59,37,37,192
3456,32,56,27,57,172
6696,71,65,76,51,263
7166,76,50,58,33,217
1476,45,57,75,64,241
2670,39,50,28,46,163
6307,66,45,36,76,223
3314,37,82,64,58,241
5495,52,41,20,56,169
2994,52,69,22,46,189
1774,61,40,43,60,204
5316,38,57,73,64,232
8743,48,58,43,40,189
441,62,46,41,68,217
6449,62,53,9,82,206
7123,76,37,50,45,208
7126,64,50,71,20,205
3701,45,42,34,35,156
1526,40,63,69,52,224
8355,56,51,62,35,204
1567,40,44,48,47,179
3438,84,42,30,50,206
2097,56,48,96,41,241
7785,69,43,44,20,176
5601,36,56,62,48,202
525,44,51,54,70,219
8289,71,42,50,52,215
634,48,58,39,30,175
3207,34,63,50,51,198
1954,39,62,36,29,166
3897,43,33,65,39,180
1676,28,55,48,30,161
3532,39,77,67,40,223
7934,36,50,45,30,161
5003,35,53,34,60,182
4848,46,48,23,53,170
7727,34,51,39,47,171
143,19,57,63,36,175
2364,34,48,45,60,187
9657,58,65,40,51,214
2056,74,31,44,71,220
3210,53,75,64,33,225
9201,52,54,65,48,219
3986,53,40,47,75,215
2450,47,61,28,59,195
4628,40,42,38,38,158
1814,62,68,26,27,183
8590,61,41,54,28,184
2768,89,53,46,14,202
832,29,62,45,74,210
5528,52,59,47,66,224
3877,46,42,40,56,184
4711,51,39,58,56,204
1549,43,67,46,66,222
854,55,32,70,50,207
2938,40,42,37,33,152
1031,34,46,34,49,163
4056,11,48,74,23,156
5197,62,88,55,49,254
6225,41,28,38,57,164
2206,32,23,30,36,121
9430,39,43,50,59,191
3199,63,65,38,36,202
2412,53,45,74,30,202
5522,54,70,50,59,233
2719,30,44,24,27,125
5438,44,31,38,37,150
6506,12,34,65,21,132
6722,50,61,53,18,182
9720,49,59,18,47,173
6591,40,38,62,51,191
182,29,46,54,46,175
6588,49,26,41,33,149
6610,40,51,43,57,191
9413,78,54,75,51,258
3344,63,62,66,46,237
5213,46,43,88,41,218
3935,54,63,62,36,215
6104,26,28,56,43,153
6901,48,56,19,46,169
6202,73,61,28,42,204
4242,77,43,61,30,211
6312,62,55,52,57,226
991,45,52,29,94,220
1792,25,61,69,46,201
1453,23,33,62,5,123
4941,25,34,44,47,150
4580,40,48,30,56,174
1818,86,63,50,40,239
6208,29,63,38,55,185
5291,58,62,31,46,197
9994,48,41,53,79,221
4364,40,30,62,32,164
7198,42,54,66,67,229
1654,34,75,45,30,184
6422,51,58,28,65,202
3189,28,58,24,47,157
3286,84,71,30,44,229
8006,30,27,49,46,152
4063,51,44,39,55,189
4067,51,51,53,53,208
6640,62,57,25,46,190
7285,52,77,18,79,226
8671,46,54,32,67,199
2248,66,41,56,36,199
3549,48,74,65,24,211
9467,65,68,51,62,246
1891,43,62,28,24,157
4847,76,58,51,67,252
2168,38,25,53,59,175
3121,67,56,31,39,193
3042,57,31,57,97,242
8358,44,34,70,69,217
8871,64,56,45,55,220
1242,69,58,34,41,202
1050,17,65,65,60,207
5981,51,56,58,67,232
9106,53,42,53,50,198
3134,69,75,31,48,223
4824,70,38,31,63,202
1419,67,62,23,57,209
399,65,64,45,60,234
3685,38,98,56,36,228
6831,52,48,92,57,249
8975,55,69,34,47,205
1686,40,61,84,48,233
9091,77,47,62,69,255
2028,47,81,64,66,258
3772,68,71,49,53,241
5523,92,35,61,24,212
199,45,20,59,47,171
72,37,43,38,64,182
1621,31,76,75,50,232
7394,18,49,33,50,150
156,49,53,61,45,208
2628,53,49,54,24,180
5689,50,48,54,85,237
150,66,29,76,66,237
9328,46,39,64,38,187
4412,48,33,63,68,212
6352,57,25,42,70,194
781,23,62,26,31,142
6468,47,33,50,46,176
6564,53,45,53,68,219
4965,1,41,60,28,130
4680,65,68,48,64,245
248,43,57,70,17,187
4810,62,40,39,56,197
4796,86,49,52,58,245
1785,60,47,35,48,190
528,47,43,18,8,116
8157,69,87,42,56,254
2339,44,55,49,17,165
5655,41,49,47,76,213
2173,37,44,42,32,155
8661,40,53,39,51,183
3769,62,22,49,35,168
68,38,61,44,61,204
6168,57,23,52,14,146
146,44,53,53,27,177
4417,59,51,65,79,254
8650,33,42,51,60,186
1233,42,70,59,59,230
3871,55,39,74,42,210
4556,60,41,44,79,224
3436,37,78,31,48,194
8985,42,58,43,36,179
2037,66,35,47,23,171
2320,47,28,75,24,174
6878,66,80,39,66,251
7681,53,57,25,70,205
6303,53,50,66,53,222
6738,78,32,28,34,172
2096,39,61,28,73,201
5538,28,73,26,31,158
230,50,38,51,33,172
2772,39,76,65,40,220
7471,64,25,52,42,183
1927,74,31,62,42,209
9706,8,58,36,38,140
9837,49,74,60,41,224
5856,73,55,64,33,225
9001,66,55,32,57,210
3972,48,60,55,41,204
2611,64,61,39,40,204
5040,56,49,29,47,181
4867,52,38,38,36,164
7634,40,49,22,62,173
9826,64,62,52,40,218
6703,51,45,53,55,204
7677,45,22,25,76,168
7275,55,42,40,69,206
3418,55,11,57,70,193
4707,32,71,47,29,179
7339,54,49,83,37,223
8153,95,68,54,57,274
4974,41,54,59,22,176
7535,23,40,56,53,172
9752,50,59,53,54,216
2665,53,42,41,56,192
8868,41,22,52,63,178
4135,55,38,32,38,163
5047,58,62,71,36,227
4683,61,71,34,50,216
8840,46,79,57,61,243
9858,39,44,18,59,160
9628,91,39,34,54,218
9761,40,77,36,25,178
5976,55,23,94,51,223
2279,56,40,57,27,180
4863,55,76,74,58,263
5255,59,24,77,52,212
2005,74,95,63,32,264
3284,59,53,57,60,229
9516,56,68,50,51,225
6269,33,54,52,58,197
4277,35,50,34,32,151
1393,31,38,32,60,161
6,58,42,36,53,189
5266,43,56,16,28,143
7228,66,73,80,45,264
5156,24,40,52,55,171
3625,47,36,39,61,183
4396,79,34,40,80,233
3857,45,55,60,43,203
4211,53,15,20,55,143
8510,56,52,50,17,175
342,51,29,46,38,164
3204,63,52,49,40,204
8664,50,40,81,52,223
7639,34,30,27,41,132
7657,50,44,42,60,196
7659,53,36,32,38,159
1495,29,43,76,42,190
6522,35,36,64,45,180
3481,63,78,61,53,255
6027,59,74,62,37,232
6767,67,51,51,42,211
9798,58,81,77,60,276
6634,45,71,46,51,213
9076,28,41,35,20,124
3254,50,57,35,47,189
8534,45,36,44,39,164
6210,59,38,55,57,209
8301,41,57,80,59,237
1924,48,45,31,52,176
5318,42,52,75,49,218
4020,37,48,55,51,191
4218,27,53,22,50,152
7800,33,55,62,60,210
5072,71,70,59,47,247
2148,52,42,37,41,172
1199,27,30,56,56,169
6552,66,56,61,61,244
1021,49,45,58,73,225
5783,67,62,39,43,211
4426,46,50,42,75,213
7585,51,54,59,32,196
7321,51,56,58,58,223
1647,25,70,63,51,209
7342,67,41,47,59,214
9757,62,45,36,59,202
8241,59,57,7,44,167
4615,60,53,51,81,245
7364,85,73,72,43,273
7916,31,63,43,52,189
9367,72,62,87,46,267
3478,47,89,55,40,231
8174,72,46,60,34,212
8496,62,63,46,25,196
7933,49,44,56,57,206
3632,46,60,73,39,218
7621,27,55,54,87,223
8581,64,75,71,51,261
2730,69,42,49,73,233
3347,45,65,32,46,188
8346,33,54,62,47,196
9182,47,64,19,36,166
7851,56,38,25,49,168
519,67,57,35,55,214
2616,75,40,65,86,266
5022,56,44,77,47,224
5583,34,37,37,25,133
4175,86,44,72,66,268
314,48,74,75,24,221
204,51,57,41,60,209
6801,77,55,59,47,238
4083,62,42,39,54,197
8423,37,73,34,54,198
8788,32,45,40,39,156
4986,48,73,38,35,194
7006,26,47,52,28,153
9512,54,47,26,46,173
5651,55,43,33,72,203
4654,49,53,66,67,235
2347,35,47,40,70,192
2119,20,43,71,59,193
2275,16,46,49,55,166
8326,33,60,77,49,219
9117,45,64,51,44,204
4046,39,42,50,51,182
9815,40,57,20,67,184
2331,60,81,45,55,241
7298,50,28,52,63,193
5333,47,51,53,69,220
4976,49,40,50,24,163
231,23,57,20,95,195
1648,50,45,31,30,156
5717,68,44,75,50,237
5619,63,39,39,61,202
1350,59,49,32,95,235
4905,39,35,62,53,189
4943,40,52,49,56,197
6327,33,11,24,37,105
8798,47,78,64,41,230
2649,41,65,36,48,190
6048,38,38,36,66,178
9120,57,34,81,45,217
8687,72,25,51,58,206
4866,55,73,49,40,217
718,59,39,71,47,216
5501,44,68,50,61,223
6823,39,58,40,39,176
8134,59,64,45,27,195
3156,66,66,70,44,246
5264,36,40,41,40,157
5029,53,56,43,58,210
5489,24,41,7,54,126
9756,59,62,38,46,205
3511,62,68,58,40,228
9596,48,72,81,50,251
8984,72,33,48,30,183
5791,52,38,11,46,147
2169,58,13,64,47,182
7257,35,45,37,66,183
7737,31,74,25,53,183
6629,52,51,12,20,135
8163,26,38,62,9,135
3471,59,37,31,73,200
8839,36,44,18,49,147
3907,35,48,48,52,183
9832,46,36,53,38,173
6159,61,38,53,69,221
9325,48,49,59,53,209
9262,53,51,67,48,219
5863,34,55,48,49,186
619,42,37,65,59,203
9528,49,51,55,38,193
6442,35,81,41,58,215
8160,37,37,23,27,124
3504,44,60,53,52,209
3440,64,37,67,29,197
7133,38,52,63,46,199
7354,35,58,31,63,187
2356,55,48,40,59,202
3807,39,41,64,48,192
9642,63,30,66,62,221
4505,74,48,64,51,237
4486,43,66,52,55,216
2155,41,31,71,35,178
9795,23,70,49,46,188
2311,22,56,60,62,200
1064,46,55,43,60,204
8595,42,56,41,60,199
7217,63,35,41,47,186
5357,69,62,43,60,234
2183,44,59,63,32,198
4858,52,62,65,51,230
1323,87,36,43,43,209
644,44,64,51,42,201
2224,15,42,49,54,160
2789,27,25,53,60,165
2492,46,43,61,34,184
1118,56,27,55,36,174
5582,39,50,39,85,213
5961,65,49,40,59,213
6788,50,33,73,49,205
9395,77,22,37,33,169
1051,68,59,87,57,271
4747,68,42,34,67,211
7189,45,32,42,60,179
7070,51,17,59,46,173
1072,42,68,49,48,207
6857,46,34,45,62,187
6176,68,49,63,44,224
4452,32,47,29,86,194
845,47,25,27,41,140
6050,23,22,56,43,144
9840,45,9,61,38,153
673,22,55,37,49,163
3561,39,56,51,69,215
2079,69,55,74,30,228
5836,70,31,35,59,195
8430,46,65,35,22,168
7584,63,62,41,47,213
2746,26,61,60,72,219
7754,48,95,57,42,242
5070,26,48,42,81,197
3576,56,84,40,58,238
1261,77,19,45,74,215
9977,44,50,50,71,215
3190,46,36,52,34,168
2891,73,29,35,60,197
4741,26,36,16,67,145
8060,50,66,53,65,234
2614,59,56,26,80,221
8071,67,64,69,60,260
580,81,28,42,59,210
3619,34,58,42,43,177
2273,41,59,29,72,201
6308,63,57,72,59,251
6563,49,37,53,50,189
799,44,29,31,1,105
5693,71,70,16,28,185
8139,33,44,48,31,156
6786,51,29,45,42,167
9062,76,14,42,37,169
8391,47,46,34,28,155
8278,40,77,67,70,254
7214,49,54,64,56,223
3367,59,43,70,61,233
5005,42,28,42,57,169
5020,40,73,53,55,221
4235,22,37,54,40,153
1022,14,25,42,63,144
5158,70,53,53,63,239
3139,62,58,43,59,222
746,33,44,68,38,183
6315,17,77,79,86,259
8431,69,36,59,83,247
524,70,63,57,40,230
9047,56,48,83,35,222
6574,79,90,60,57,286
6846,44,59,57,62,222
9638,52,54,44,71,221
3985,62,39,80,80,261
2761,65,78,50,61,254
247,26,72,63,62,223
2352,63,19,29,21,132
1457,22,38,56,45,161
9958,51,57,53,54,215
2926,45,36,89,19,189
6679,34,36,36,44,150
8896,32,67,56,64,219
2562,70,53,55,28,206
7728,57,51,50,50,208
1230,60,64,64,59,247
2835,35,38,71,38,182
86,65,31,81,22,199
2798,56,72,66,38,232
9969,15,69,39,58,181
6559,53,25,39,60,177
1338,29,60,47,55,191
6804,33,47,47,44,171
9313,39,36,30,76,181
1948,27,47,50,85,209
3644,41,37,38,75,191
1764,74,31,57,74,236
2610,21,60,36,53,170
4435,61,32,92,52,237
5083,32,34,66,32,164
7497,30,61,83,30,204
719,47,49,66,56,218
6879,48,76,59,44,227
2264,22,37,61,31,151
821,44,19,26,45,134
8561,57,46,45,64,212
3892,64,77,62,69,272
112,46,67,77,79,269
1961,49,29,31,63,172
1560,32,51,43,69,195
8308,39,65,43,54,201
1174,37,60,55,50,202
8805,45,24,51,68,188
7414,62,42,64,54,222
7772,78,39,69,46,232
9308,65,56,51,57,229
1926,66,52,50,52,220
9598,42,47,65,49,203
8304,42,72,52,49,215
2114,26,70,61,66,223
8768,85,45,59,40,229
5762,56,47,52,63,218
8596,56,26,51,34,167
9866,33,49,40,59,181
866,27,58,30,60,175
346,34,53,14,14,115
648,71,39,58,45,213
9178,37,43,36,56,172
1008,42,58,53,68,221
2189,54,70,16,41,181
3981,69,72,65,19,225
2417,56,29,35,65,185
5432,72,31,58,67,228
7386,72,54,31,78,235
4614,47,36,46,75,204
7336,58,68,38,31,195
3875,42,55,48,61,206
8000,35,50,42,19,146
3265,72,46,70,66,254
7514,41,83,27,21,172
529,64,44,29,53,190
33,71,33,55,66,225
587,55,24,33,68,180
3329,70,52,56,57,235
3492,65,64,39,56,224
1711,68,51,34,46,199
7710,46,72,36,46,200
662,45,49,42,49,185
9901,54,33,72,60,219
3546,11,72,69,58,210
7678,40,63,65,74,242
9589,48,58,46,69,221
7095,40,70,57,54,221
3529,58,72,62,17,209
3531,35,71,47,55,208
2638,63,45,44,57,209
4025,44,80,28,9,161
1017,47,38,48,36,169
6821,62,36,57,60,215
3655,32,27,34,51,144
1772,76,36,44,65,221
447,54,65,67,50,236
9449,68,70,60,36,234
2104,59,37,66,19,181
936,47,67,31,14,159
8521,44,45,63,52,204
3464,39,68,63,60,230
7047,38,42,79,49,208
9218,71,67,64,55,257
4877,45,55,56,53,209
1583,61,67,57,19,204
1861,45,61,31,36,173
8784,46,47,42,27,162
905,31,55,42,79,207
7942,68,66,50,40,224
36,52,57,57,29,195
3249,85,77,39,40,241
1497,92,37,58,90,277
1608,64,63,40,62,229
5463,67,59,36,40,202
6074,38,54,49,57,198
6837,39,47,53,68,207
2734,41,8,47,61,157
2370,8,63,60,27,158
7847,27,68,31,61,187
785,48,60,56,47,211
9346,56,62,79,67,264
5637,68,54,8,50,180
4950,51,44,63,44,202
7996,53,28,53,47,181
9142,39,63,36,25,163
4664,58,45,67,30,200
8312,61,50,38,68,217
3403,46,26,67,51,190
8806,62,50,70,41,223
8151,23,54,52,55,184
1446,49,21,71,43,184
1596,58,34,39,50,181
2786,81,44,51,26,202
9107,28,26,80,57,191
9253,39,82,41,47,209
810,53,68,76,40,237
7829,51,53,35,47,186
7303,31,47,30,78,186
6497,32,34,37,30,133
5485,69,47,45,64,225
5605,39,91,40,40,210
2179,48,58,14,48,168
9864,52,71,68,61,252
7852,43,53,40,45,181
7089,42,32,42,66,182
2094,63,61,46,65,235
7459,92,38,47,40,217
1998,48,81,15,24,168
7511,33,68,53,51,205
3901,58,59,32,54,203
9210,18,51,50,60,179
2615,28,38,45,28,139
1138,30,53,42,62,187
2021,56,56,44,61,217
2380,51,48,46,68,213
1533,36,54,50,37,177
6544,56,53,34,68,211
2932,30,54,40,65,189
9392,82,38,68,51,239
9953,35,33,33,70,171
9475,48,0,71,26,145
3963,49,50,39,44,182
2992,68,41,61,52,222
7324,58,41,66,8,173
5515,66,46,34,79,225
1295,43,64,36,40,183
2896,50,13,66,46,175
6203,16,68,40,41,165
2451,42,55,45,70,212
3391,36,58,74,40,208
6503,25,38,63,74,200
9377,26,34,40,57,157
2488,59,67,68,50,244
872,48,97,46,94,285
9886,39,65,21,57,182
2566,63,57,45,39,204
9319,54,77,26,46,203
1976,43,38,38,49,168
5379,59,44,28,43,174
7281,49,39,37,44,169
8573,57,66,53,85,261
7611,67,34,24,67,192
5441,50,41,69,51,211
6688,46,45,49,83,223
5974,62,26,62,48,198
5500,36,40,53,55,184
1547,36,61,11,79,187
6036,35,79,59,58,231
1538,40,57,47,45,189
3588,28,7,62,50,147
4199,63,27,42,72,204
681,65,54,29,39,187
2619,48,48,68,62,226
3662,50,41,62,60,213
9557,19,32,32,49,132
4100,47,32,12,28,119
9437,43,42,64,44,193
2982,42,79,73,48,242
7828,59,43,51,35,188
1782,59,57,64,44,224
2058,42,77,69,38,226
3584,31,56,39,58,184
9639,52,59,48,63,222
3361,41,59,17,61,178
535,51,42,59,35,187
8452,53,58,18,58,187
7638,35,40,42,34,151
5125,54,36,57,18,165
9004,56,30,36,18,140
1444,54,48,31,54,187
7924,43,59,59,48,209
5733,72,42,80,69,263
7334,80,58,27,59,224
1176,60,58,50,85,253
8720,30,46,61,82,219
8568,35,73,72,45,225
430,50,77,51,41,219
8318,40,36,30,77,183
9935,73,68,52,62,255
8623,56,23,33,79,191
8550,47,52,47,14,160
7447,56,51,44,56,207
3708,38,51,90,42,221
4252,60,61,47,70,238
4558,25,57,57,11,150
3441,41,60,71,44,216
4933,45,73,41,66,225
7368,90,19,12,41,162
3623,58,58,49,77,242
1487,47,57,35,41,180
6339,58,31,24,70,183
1134,48,18,43,50,159
3269,56,30,60,29,175
9342,50,35,39,50,174
8931,30,83,64,61,238
1429,32,47,41,59,179
3842,48,68,65,47,228
8608,50,22,44,38,154
8909,25,46,60,74,205
4451,50,50,36,53,189
3285,35,49,57,36,177
7374,35,31,64,74,204
6358,54,11,58,55,178
1166,39,29,66,65,199
1811,38,39,52,32,161
3039,46,63,50,36,195
60,30,35,78,44,187
7410,31,67,37,70,205
8014,28,68,61,40,197
7259,33,33,65,31,162
2126,59,64,58,40,221
6709,59,38,37,66,200
4122,40,55,47,27,169
8617,27,26,12,68,133
7371,54,50,61,36,201
1141,72,44,45,42,203
8309,68,50,42,58,218
8935,83,49,45,49,226
6763,7,57,58,65,187
9728,32,36,44,33,145
4263,52,42,45,67,206
7994,81,47,53,29,210
1737,58,29,65,41,193
1821,53,45,65,2,165
543,64,60,99,47,270
329,75,56,36,54,221
8193,46,44,64,66,220
9443,45,59,37,87,228
5173,53,37,34,40,164
8479,62,42,25,49,178
8394,45,49,44,66,204
792,26,77,38,57,198
9503,31,52,40,19,142
9104,34,45,78,29,186
9501,25,37,78,44,184
7730,76,52,35,49,212
149,33,34,51,76,194
194,56,38,55,63,212
7612,43,63,41,58,205
65,61,67,28,56,212
5091,72,54,41,71,238
9907,44,56,33,19,152
1501,9,38,60,30,137
6498,62,62,27,65,216
2777,39,29,51,60,179
9409,42,44,39,60,185
6669,33,32,61,31,157
6850,52,64,58,70,244
5110,71,53,34,27,185
5947,47,58,20,39,164
683,26,42,64,61,193
4258,42,53,30,64,189
5249,29,36,22,70,157
2629,46,54,50,44,194
490,33,52,67,66,218
6268,45,22,33,58,158
2318,38,19,61,30,148
9900,28,60,28,38,154
5227,61,22,43,32,158
95,35,60,55,62,212
6665,47,46,48,61,202
7913,74,46,18,53,191
1839,42,43,48,66,199
4359,41,57,32,30,160
672,35,65,43,49,192
7895,45,44,65,39,193
7628,44,69,64,35,212
5518,54,47,21,67,189
4174,56,79,82,30,247
2452,19,59,64,76,218
9988,44,46,94,76,260
6652,58,33,75,58,224
8228,58,60,65,43,226
1953,71,35,53,51,210
950,43,40,61,36,180
9354,68,21,48,46,183
4760,48,67,66,56,237
5408,39,55,58,44,196
7223,14,38,34,47,133
2463,30,43,47,35,155
6371,94,19,28,82,223
2716,53,37,29,39,158
808,34,57,49,69,209
7405,49,45,24,20,138
2257,47,66,21,82,216
2039,50,64,73,57,244
29,36,26,61,47,170
6595,28,40,45,51,164
8797,44,48,66,53,211
1633,49,23,33,49,154
7827,78,39,30,44,191
6235,73,23,64,78,238
349,56,34,69,100,259
4874,57,62,37,37,193
4967,60,31,64,23,178
2787,64,43,42,70,219
6201,72,24,47,63,206
5293,65,29,40,58,192
2106,50,31,44,95,220
354,75,58,58,95,286
809,62,50,55,85,252
9444,55,56,25,41,177
7931,41,37,49,48,175
4935,57,31,58,44,190
2,66,63,30,60,219
9066,29,31,34,67,161
8302,59,34,46,26,165
4285,42,42,22,54,160
3003,50,78,45,56,229
6040,52,43,56,42,193
4878,23,39,26,51,139
2399,31,36,18,43,128
7615,61,35,41,59,196
7839,45,52,46,42,185
4828,70,46,70,62,248
9013,48,50,56,45,199
4940,72,60,45,53,230
155,40,64,35,83,222
6133,58,49,51,51,209
5069,24,55,60,24,163
4513,41,56,78,44,219
2162,26,36,57,25,144
2188,70,87,55,48,260
6129,40,44,1,4,89
8993,33,60,43,69,205
3375,57,45,48,52,202
3647,76,38,22,61,197
1148,71,59,52,70,252
4381,57,66,100,64,287
2395,41,62,38,51,192
2003,41,42,22,43,148
6780,46,70,42,50,208
5148,61,59,44,47,211
241,55,65,47,92,259
5112,47,11,57,56,171
7976,71,65,52,11,199
527,55,45,43,54,197
4781,50,60,58,35,203
6280,40,45,50,0,135
9751,53,64,28,45,190
4467,65,53,34,36,188
2140,59,52,66,60,237
2542,49,37,60,48,194
4437,75,70,22,33,200
2476,45,76,51,43,215
9888,61,48,59,77,245
4254,71,39,66,35,211
2848,46,32,36,53,167
8601,49,75,32,52,208
7179,66,64,85,81,296
8624,61,33,59,40,193
5999,28,36,69,31,164
5107,50,41,46,52,189
7848,52,60,51,26,189
4449,27,34,73,39,173
4223,66,50,38,70,224
2885,35,43,53,52,183
6319,53,58,64,32,207
8693,65,38,51,42,196
4553,46,53,70,46,215
8305,79,64,41,37,221
286,24,23,52,53,152
6615,72,43,34,59,208
1849,31,33,59,67,190
8730,54,44,60,44,202
7270,38,52,41,18,149
7923,30,25,46,68,169
3782,59,59,51,50,219
5428,42,64,56,40,202
5048,43,47,45,71,206
2253,82,66,48,31,227
9097,47,21,31,27,126
5811,41,18,58,81,198
2002,45,70,60,76,251
7387,62,53,49,53,217
2086,31,56,37,39,163
7167,41,47,37,67,192
2435,61,26,57,35,179
6822,34,22,47,72,175
374,34,36,40,84,194
7494,33,39,30,36,138
351,50,62,40,46,198
7128,24,46,71,55,196
6217,52,64,63,50,229
405,33,66,24,63,186
9072,47,37,62,54,200
6160,41,23,13,54,131
2564,58,58,69,51,236
8620,52,58,57,58,225
2415,55,52,78,45,230
3208,60,40,46,24,170
7816,53,80,56,62,251
4409,53,58,88,30,229
4284,30,52,59,29,170
9268,66,54,54,35,209
1298,58,50,31,63,202
1465,16,54,66,71,207
9498,42,35,26,52,155
69,69,33,50,29,181
2743,53,33,77,28,191
1389,57,34,67,57,215
460,33,62,51,44,190
2971,47,47,85,44,223
9421,58,45,41,25,169
7204,54,54,51,36,195
8777,39,59,47,61,206
6787,32,41,37,62,172
7706,74,75,58,36,243
6963,64,55,68,57,244
7112,59,28,25,54,166
1494,70,64,56,59,249
1384,47,52,43,52,194
4537,44,69,55,26,194
9153,36,26,62,54,178
8865,47,70,53,35,205
5259,40,54,48,48,190
2335,47,61,57,44,209
1498,30,61,84,72,247
2709,26,67,43,55,191
7859,49,51,51,58,209
9068,57,30,34,33,154
2258,49,81,64,60,254
5199,28,6,70,41,145
9811,64,65,56,39,224
2127,75,40,59,74,248
8897,25,81,35,49,190
5341,70,40,47,57,214
652,39,58,57,51,205
2817,34,42,37,48,161
9333,70,12,45,26,153
6494,57,37,42,56,192
2689,48,44,84,44,220
9547,64,69,64,58,255
1068,63,62,68,32,225
1014,41,45,48,69,203
4975,50,36,49,41,176
1896,35,46,61,44,186
517,12,45,39,69,165
8136,26,55,61,54,196
5755,73,52,53,71,249
3574,46,33,43,61,183
5065,83,55,27,43,208
597,85,33,46,53,217
5843,53,44,60,56,213
2880,74,57,60,43,234
8717,50,61,44,59,214
9043,37,36,46,27,146
951,78,65,10,32,185
4469,75,19,69,78,241
5667,65,46,64,76,251
5437,37,63,47,58,205
1723,71,69,46,80,266
2861,48,62,39,45,194
6520,44,56,49,37,186
6691,28,58,65,25,176
8701,47,59,32,42,180
5208,28,37,79,41,185
1180,79,73,44,33,229
2025,37,34,62,56,189
266,66,42,37,54,199
3657,28,63,32,40,163
559,47,55,44,38,184
4058,45,59,34,81,219
6379,64,56,62,72,254
3075,44,70,47,54,215
2067,51,61,47,52,211
7959,42,23,57,57,179
9892,72,14,28,63,177
5416,39,37,59,39,174
7231,47,82,67,64,260
5487,57,82,43,64,246
8854,73,81,76,32,262
7742,26,44,30,65,165
7843,33,38,50,48,169
9599,39,64,38,57,198
7337,43,48,44,50,185
3422,57,53,53,38,201
1237,54,60,63,40,217
752,42,33,43,28,146
8517,32,38,58,45,173
8247,48,62,65,39,214
3899,39,56,76,31,202
4994,63,84,37,46,230
8461,9,51,23,49,132
988,74,38,46,34,192
7556,44,65,42,44,195
7774,53,37,43,23,156
2738,68,23,43,76,210
1867,74,68,58,48,248
5503,54,60,54,61,229
5665,55,50,41,59,205
4162,46,42,59,71,218
9947,26,56,43,65,190
5250,56,41,43,83,223
2053,40,25,65,36,166
2232,84,46,45,73,248
509,55,54,37,23,169
7087,73,49,41,52,215
5764,37,32,40,72,181
186,61,65,96,59,281
5080,46,35,45,59,185
5023,45,71,46,49,211
3358,59,52,60,49,220
1750,61,52,41,50,204
8575,61,27,64,32,184
3243,67,48,47,57,219
8439,54,43,41,63,201
22,64,46,37,67,214
7181,86,10,47,48,191
7864,86,51,58,0,195
8635,67,56,62,60,245
4624,81,47,53,66,247
5444,43,53,46,50,192
2843,52,23,18,61,154
5482,46,47,72,64,229
1246,46,45,55,23,169
3227,57,31,35,46,169
2446,40,60,37,60,197
2129,77,50,45,74,246
8,75,18,32,32,157
4809,60,54,63,51,228
2456,80,49,49,65,243
3264,73,27,45,49,194
3823,56,56,61,22,195
6158,48,49,43,44,184
5625,54,44,29,63,190
331,69,15,59,43,186
3007,56,48,14,27,145
9841,68,52,51,30,201
6871,52,64,50,52,218
4327,40,45,58,49,192
9898,46,42,54,51,193
267,59,41,43,62,205
9054,38,25,79,33,175
7998,56,48,46,34,184
6426,40,51,58,46,195
9314,40,34,57,71,202
5803,66,46,35,64,211
7164,49,49,65,55,218
2064,63,71,59,50,243
2986,41,44,39,51,175
2972,68,47,39,41,195
953,38,61,59,51,209
4870,70,69,59,58,256
2225,44,70,51,79,244
294,61,37,54,56,208
2009,56,50,60,29,195
5818,33,61,1,53,148
1991,68,64,52,34,218
9882,71,74,38,18,201
4798,55,50,32,44,181
5552,43,12,46,55,156
4561,24,32,64,37,157
9083,64,48,40,17,169
1732,67,37,49,56,209
523,55,63,28,66,212
1466,76,35,87,48,246
1707,45,42,61,34,182
7139,24,71,25,42,162
1185,22,51,67,54,194
4891,86,30,61,14,191
4717,38,63,48,65,214
4937,34,32,43,49,158
8599,62,72,26,65,225
6131,46,64,18,49,177
2659,50,38,22,52,162
4070,64,77,56,75,272
9749,67,48,13,26,154
7273,44,56,81,41,222
2271,45,52,47,66,210
4190,65,24,25,60,174
6180,19,35,67,78,199
7777,29,32,30,53,144
3809,46,61,45,67,219
176,47,32,34,69,182
6641,42,35,41,49,167
3979,15,42,42,59,158
9883,61,65,42,80,248
5099,50,24,54,53,181
573,55,55,54,72,236
8894,28,53,47,80,208
563,40,37,70,43,190
2948,40,20,63,20,143
3427,49,45,51,69,214
7993,79,21,51,51,202
1668,68,72,59,53,252
8062,44,48,49,63,204
6068,36,62,71,54,223
9956,82,54,19,28,183
2696,29,51,31,79,190
8124,58,59,53,56,226
1217,53,37,20,28,138
3126,52,24,57,58,191
8728,59,18,49,62,188
7691,42,47,75,41,205
6727,65,56,58,36,215
3222,40,31,82,59,212
7635,62,76,54,15,207
5514,51,26,52,61,190
3453,61,47,48,56,212
1083,11,32,65,57,165
4003,49,48,60,66,223
1614,39,48,58,59,204
7902,37,70,23,43,173
8719,47,54,72,45,218
7802,24,38,27,64,153
9845,35,44,61,45,185
4483,66,54,47,37,204
9893,48,48,56,66,218
71,46,49,48,33,176
7937,29,54,59,66,208
4527,35,58,36,47,176
4897,32,23,50,47,152
1655,60,76,47,52,235
9679,50,81,26,59,216
8824,35,51,50,52,188
5617,68,54,26,50,198
9867,37,54,58,40,189
1881,48,72,45,12,177
8942,48,22,64,6,140
1510,15,42,53,69,179
9381,74,60,95,80,309
2963,15,48,55,29,147
3768,61,32,62,81,236
5087,40,45,52,48,185
5109,36,71,42,47,196
4817,46,67,58,66,237
6128,57,71,56,29,213
4198,63,25,70,53,211
4035,60,53,25,42,180
6561,35,69,67,57,228
5001,52,43,67,35,197
16,63,80,64,52,259
3463,44,61,69,31,205
4189,41,35,61,16,153
5007,34,16,40,34,124
6604,72,40,29,48,189
5155,64,66,69,30,229
5313,87,46,59,40,232
6777,43,58,46,68,215
1695,63,48,60,65,236
3917,46,27,63,54,190
8068,55,60,56,56,227
6428,53,25,52,53,183
4173,32,28,48,69,177
3218,59,33,38,66,196
3135,54,49,35,26,164
6825,20,41,65,42,168
1213,54,44,43,52,193
7893,52,25,51,70,198
4311,10,53,65,65,193
3141,55,55,64,39,213
7619,43,42,57,82,224
5835,39,40,40,49,168
4578,57,36,34,44,171
1387,41,52,64,76,233
4529,49,22,28,42,141
2436,35,43,44,60,182
2889,34,57,54,68,213
595,14,80,51,60,205
3166,29,20,35,58,142
7980,44,62,31,32,169
172,49,31,48,43,171
5174,49,52,61,55,217
9684,54,75,50,75,254
2312,57,33,48,62,200
805,64,49,26,70,209
2102,32,38,72,69,211
611,53,59,63,62,237
7409,70,65,53,24,212
4322,70,20,76,55,221
3059,63,36,50,37,186
8870,56,31,41,52,180
2328,20,40,53,28,141
3081,37,41,45,51,174
5033,27,30,62,65,184
3591,41,51,69,61,222
4123,66,41,41,62,210
1163,65,33,48,65,211
1436,45,40,30,61,176
3786,13,30,29,64,136
5414,36,30,31,50,147
2828,63,54,47,57,221
909,67,58,69,27,221
5130,42,30,42,31,145
5362,64,37,58,56,215
114,44,37,55,35,171
4969,54,75,61,64,254
9775,46,76,19,59,200
308,31,45,61,47,184
1824,61,26,86,37,210
8823,38,48,93,60,239
7627,60,34,60,48,202
7468,46,64,63,15,188
5820,50,30,48,40,168
2134,22,44,43,28,137
9441,28,74,45,36,183
9692,34,57,23,43,157
7490,55,41,36,51,183
9998,65,59,62,24,210
4749,54,66,47,32,199
9012,48,65,45,61,219
1032,36,37,45,64,182
6530,61,47,65,58,231
7010,50,45,58,50,203
8216,50,48,58,48,204
7215,61,68,41,48,218
3991,9,75,61,61,206
2244,64,45,28,51,188
7688,66,58,57,62,243
8373,9,63,54,77,203
9985,56,61,30,64,211
5677,37,40,71,58,206
541,63,57,57,51,228
3273,50,74,58,52,234
8673,51,77,50,31,209
8641,62,35,41,45,183
4745,52,46,44,50,192
3429,52,69,53,48,222
5831,48,37,61,39,185
228,40,55,40,55,190
3313,49,56,11,51,167
1666,43,65,31,31,170
4368,55,61,72,44,232
6458,46,51,43,66,206
2633,55,39,44,47,185
8470,45,40,54,78,217
386,33,51,49,74,207
3957,40,79,78,46,243
7748,52,59,43,51,205
8969,35,58,53,59,205
8411,65,82,66,39,252
3360,57,52,77,79,265
2494,44,58,40,41,183
1221,32,26,42,75,175
2561,55,38,63,53,209
6741,52,72,81,36,241
2667,70,32,60,55,217
6972,52,23,26,55,156
4413,61,62,36,41,200
56,37,52,32,78,199
3792,52,41,63,77,233
7543,44,16,22,59,141
2091,49,56,50,59,214
5756,53,32,26,77,188
1854,58,49,58,30,195
5071,76,62,58,47,243
7881,42,31,60,21,154
3168,69,51,52,36,208
8682,72,47,51,51,221
5185,49,38,40,49,176
3100,46,49,52,82,229
7789,38,63,50,46,197
9286,26,39,25,27,117
1351,41,58,62,47,208
5399,46,46,76,59,227
8164,68,44,52,29,193
488,59,49,37,74,219
7003,63,57,48,43,211
7256,40,60,48,58,206
8194,29,50,73,56,208
3136,21,51,49,17,138
6306,37,37,58,47,179
7491,54,75,44,50,223
8589,73,73,18,56,220
6491,70,44,49,70,233
4585,57,49,36,36,178
9005,24,67,48,40,179
6153,26,65,58,33,182
3835,73,51,53,32,209
6501,31,26,36,31,124
5740,56,46,46,42,190
8393,41,42,41,39,163
7254,78,63,60,24,225
2389,67,67,71,33,238
7150,50,49,58,42,199
2403,41,63,58,35,197
3309,54,62,75,50,241
7946,25,20,76,62,183
4217,52,26,45,49,172
3277,49,19,8,66,142
2280,41,48,44,54,187
6444,50,44,44,42,180
2535,44,40,27,25,136
4246,47,63,31,41,182
4142,75,47,57,48,227
8822,42,53,37,30,162
1834,72,61,58,55,246
1210,85,29,76,70,260
3149,55,90,54,58,257
8191,35,48,61,42,186
8875,35,50,59,44,188
3056,76,35,73,67,251
2980,43,30,39,67,179
4946,63,56,40,60,219
9245,27,35,52,27,141
6694,64,45,62,62,233
2571,79,64,42,77,262
435,38,55,49,50,192
5203,27,46,51,35,159
3948,48,37,48,48,181
6439,49,66,81,64,260
7784,74,37,49,49,209
40,51,47,53,44,195
3602,44,29,80,67,220
2654,51,78,45,65,239
5714,62,49,50,43,204
7591,75,31,9,49,164
6345,89,47,51,49,236
205,54,56,36,49,195
2953,33,43,54,55,185
945,37,38,43,48,166
3777,43,38,24,46,151
254,58,52,36,87,233
5576,66,54,56,55,231
305,100,62,35,56,253
4287,38,23,40,81,182
3716,58,34,18,71,181
621,47,21,36,66,170
4227,24,45,32,57,158
6284,46,62,36,38,182
383,70,49,57,40,216
7421,55,41,75,68,239
6366,45,28,70,64,207
3876,55,48,56,41,200
8058,64,77,51,77,269
4425,50,37,48,35,170
956,48,63,37,47,195
6396,64,60,53,77,254
2591,40,52,75,75,242
7910,66,66,22,53,207
9991,43,38,37,71,189
4116,57,18,84,51,210
2543,60,36,61,36,193
3366,52,84,33,40,209
5237,19,89,29,15,152
6707,33,69,58,71,231
5663,36,62,18,45,161
8708,56,46,54,59,215
4788,60,41,56,43,200
8648,67,60,35,26,188
3489,40,21,48,69,178
8807,50,30,65,41,186
4059,64,38,56,71,229
6536,67,33,49,52,201
8220,72,67,63,27,229
9999,51,44,53,42,190
4444,55,27,27,56,165
7039,39,50,71,62,222
1681,34,42,73,47,196
8130,26,56,35,44,161
8395,37,62,18,42,159
8715,65,40,61,26,192
8513,26,63,88,31,208
3604,35,47,59,50,191
7361,54,53,20,39,166
2098,47,75,38,55,215
6912,46,66,38,42,192
4618,41,95,22,53,211
8769,78,47,82,23,230
9455,31,48,18,60,157
5435,64,57,58,50,229
8035,55,46,18,44,163
9340,55,31,49,46,181
7992,34,44,49,48,175
8872,40,73,52,42,207
4690,24,43,47,41,155
2372,42,33,53,58,186
9535,44,43,52,37,176
3026,73,49,66,44,232
2947,49,65,41,60,215
4851,34,41,53,54,182
695,23,58,26,59,166
4000,83,39,20,23,165
9810,62,53,26,49,190
412,45,38,67,60,210
8140,62,58,93,56,269
1941,67,42,38,50,197
6016,58,36,74,53,221
8196,36,65,59,16,176
5634,43,43,31,76,193
2329,42,53,58,59,212
2112,89,65,36,27,217
3661,55,25,45,48,173
4422,52,41,54,48,195
954,39,46,36,50,171
8067,38,27,46,46,157
2788,27,44,65,79,215
604,67,62,62,53,244
3922,44,31,44,41,160
8384,63,53,78,44,238
5914,27,62,53,59,201
4399,60,39,75,55,229
7869,23,68,44,44,179
2937,81,59,57,47,244
6575,40,49,64,46,199
8675,68,41,59,67,235
3811,60,64,65,73,262
9939,41,51,45,54,191
5315,64,57,67,45,233
7858,14,58,65,61,198
6023,51,73,40,38,202
1795,10,83,63,45,201
9701,74,59,78,52,263
2809,54,60,44,40,198
4292,12,35,87,31,165
7542,44,33,62,36,175
5335,52,47,68,44,211
1747,49,58,50,51,208
1630,40,61,37,14,152
2076,25,58,67,36,186
9156,64,45,78,57,244
4436,50,51,66,31,198
9736,47,55,48,35,185
4631,15,71,34,47,167
7867,49,42,27,45,163
4108,64,26,33,71,194
2303,68,26,70,57,221
2460,47,46,29,49,171
6683,57,29,38,50,174
5214,35,60,55,18,168
3762,62,45,61,39,207
2984,70,45,61,47,223
3874,60,38,65,38,201
8882,45,65,32,72,214
7282,65,52,67,38,222
5267,63,59,34,58,214
1360,71,73,68,19,231
5913,45,53,28,42,168
1793,23,58,60,72,213
6959,59,48,47,44,198
2175,65,20,5,41,131
2834,45,36,52,66,199
2575,72,46,21,41,180
8910,44,60,85,57,246
9306,46,50,44,63,203
108,30,43,66,38,177
8141,52,74,47,34,207
8322,70,62,52,45,229
1799,35,35,47,32,149
7648,52,60,43,31,186
1945,55,35,72,23,185
6860,44,20,60,51,175
3583,42,21,33,44,140
8269,51,49,52,66,218
1943,53,42,48,58,201
8027,35,41,42,32,150
2606,44,67,65,36,212
5418,48,41,59,40,188
9716,27,67,75,55,224
4548,62,46,53,18,179
2199,66,39,65,32,202
1028,61,59,48,38,206
19,38,81,33,79,231
4919,30,25,40,39,134
5513,49,44,86,55,234
7276,65,51,36,42,194
7274,55,42,29,60,186
8512,41,44,29,37,151
8215,46,56,43,52,197
4528,37,54,74,32,197
4900,21,68,54,40,183
8747,45,44,27,34,150
7347,65,49,36,57,207
9911,43,68,23,46,180
7372,55,38,32,72,197
1171,23,33,40,66,162
6557,30,80,53,52,215
1052,59,54,64,17,194
2765,51,59,26,72,208
4017,36,41,38,72,187
2453,50,51,59,58,218
904,25,50,57,40,172
459,46,42,54,57,199
7113,33,37,57,70,197
5611,43,57,28,66,194
6533,17,52,27,44,140
6290,51,45,41,44,181
7326,61,41,35,47,184
8240,23,40,66,36,165
5311,33,60,48,44,185
113,54,43,34,30,161
2873,58,56,71,45,230
8898,67,57,86,75,285
1167,56,38,63,63,220
9089,31,77,39,39,186
7205,70,43,59,27,199
7227,43,23,40,25,131
4362,23,58,58,50,189
4735,27,37,50,32,146
5656,46,19,42,45,152
2635,25,36,50,48,159
5475,33,25,30,51,139
6813,39,53,47,35,174
6247,35,64,34,39,172
1169,57,55,67,32,211
118,69,63,33,56,221
9747,57,62,24,51,194
3862,68,44,58,74,244
5460,42,75,51,61,229
4653,64,41,43,47,195
2917,61,32,59,57,209
9574,63,34,83,79,259
9746,45,29,48,47,169
2833,39,73,31,37,180
1367,59,26,52,47,184
9848,65,62,47,73,247
6858,35,11,51,36,133
4841,47,41,54,60,202
3311,57,55,13,55,180
5060,58,60,51,22,191
5918,42,45,34,59,180
7845,51,55,71,54,231
5645,42,52,69,46,209
892,43,33,31,68,175
7434,62,57,34,22,175
8537,35,59,61,59,214
8740,38,58,36,58,190
3151,64,23,10,53,150
125,68,73,48,58,247
1810,53,21,82,49,205
4161,63,37,42,5,147
600,47,53,46,59,205
4319,17,62,50,49,178
5907,52,38,36,35,161
6132,69,46,51,46,212
818,72,47,29,39,187
1632,22,64,56,35,177
1440,52,13,80,74,219
3637,53,44,31,47,175
5587,43,36,77,49,205
8962,31,62,37,45,175
5545,39,33,64,49,185
6369,52,48,43,64,207
7646,61,45,87,57,250
7733,59,13,45,40,157
7367,68,65,33,50,216
4434,30,50,48,63,191
11,49,72,43,62,226
7101,35,70,46,55,206
1313,35,36,41,38,150
6101,63,60,38,24,185
5652,46,35,54,60,195
4375,53,45,61,85,244
8500,68,48,48,43,207
2864,52,47,55,53,207
902,49,43,21,36,149
2123,41,44,68,36,189
6419,48,42,46,75,211
8339,50,58,61,55,224
3377,32,21,58,41,152
7136,45,18,34,53,150
5998,57,29,51,54,191
1863,30,66,11,60,167
4697,51,44,59,87,241
7501,59,41,18,56,174
900,67,9,47,49,172
5508,47,48,27,44,166
8401,45,53,42,63,203
5425,24,45,40,70,179
5026,41,54,62,65,222
6968,49,62,71,41,223
1564,30,53,43,40,166
1921,43,75,63,37,218
6531,61,48,46,34,189
7208,57,56,58,43,214
6169,35,67,57,33,192
214,64,54,58,56,232
1165,48,48,47,38,181
1095,27,56,64,37,184
3795,65,66,53,53,237
2122,78,55,44,100,277
6764,50,37,19,73,179
7622,51,19,49,66,185
6568,36,41,47,62,186
17,43,57,75,20,195
8995,55,67,48,54,224
4008,35,54,61,49,199
3971,52,49,40,37,178
7294,63,53,60,14,190
5724,51,24,80,29,184
5991,48,48,64,60,220
7642,36,33,75,54,198
1716,53,53,45,48,199
803,32,59,46,39,176
6409,28,58,27,61,174
9519,81,67,53,61,262
7116,63,56,36,49,204
828,32,65,51,60,208
4985,64,52,70,67,253
4110,50,39,70,71,230
8519,36,21,51,55,163
4845,63,34,77,58,232
5119,31,48,45,54,178
6417,47,65,55,45,212
2307,75,57,49,42,223
3664,47,52,37,56,192
4777,40,58,35,30,163
9722,67,51,66,34,218
6661,37,48,64,79,228
4329,36,4,53,42,135
8659,33,42,49,72,196
6994,47,64,56,42,209
5950,35,61,72,59,227
7704,50,56,24,59,189
8637,49,56,54,48,207
5887,55,53,35,38,181
34,68,36,32,45,181
7675,33,32,69,47,181
1489,44,21,53,48,166
1788,38,56,68,38,200
2893,65,39,90,50,244
2054,59,60,31,24,174
8189,65,61,32,48,206
6796,45,69,51,29,194
7473,26,67,50,43,186
1580,39,73,35,52,199
9238,53,48,28,69,198
7438,53,30,54,38,175
8974,44,38,55,63,200
3272,77,48,54,26,205
2459,48,50,50,69,217
8367,58,32,42,50,182
5218,29,28,73,58,188
1670,91,39,81,55,266
5189,45,47,18,48,158
262,47,21,42,57,167
5578,64,44,54,49,211
1809,43,40,47,45,175
3940,36,32,30,73,171
5731,65,68,68,59,260
4780,38,66,45,66,215
7738,47,53,59,64,223
7376,40,25,54,58,177
7680,41,47,65,50,203
188,50,78,22,56,206
1459,58,41,45,17,161
2424,68,41,60,33,202
4601,79,39,47,41,206
9221,43,34,58,58,193
7496,53,51,52,51,207
8973,54,36,52,33,175
2124,74,34,78,46,232
537,44,66,74,30,214
4980,62,42,59,62,225
7527,34,39,35,42,150
9154,30,48,68,47,193
1396,18,59,31,40,148
1302,31,62,57,52,202
3537,52,33,78,49,212
3989,60,56,42,52,210
8010,47,46,65,82,240
3262,41,43,38,79,201
2845,37,53,46,81,217
4386,55,55,29,75,214
5626,55,48,82,61,246
1980,72,55,31,46,204
14,49,43,80,33,205
5113,55,85,41,37,218
2729,57,46,46,46,195
1708,83,35,51,39,208
2464,79,29,49,69,226
5367,35,42,58,60,195
9846,41,47,53,35,176
7241,41,52,49,44,186
7665,48,20,58,54,180
5479,60,68,62,47,237
7837,25,44,50,58,177
2895,35,65,59,24,183
2235,77,29,32,54,192
7856,47,43,60,41,191
190,50,50,47,59,206
4389,23,50,55,25,153
9990,18,51,70,60,199
7171,56,57,15,57,185
4188,34,83,44,49,210
4792,43,45,29,48,165
3496,54,31,69,61,215
9450,55,40,36,29,160
3944,60,59,70,46,235
8223,75,60,46,52,233
8467,23,56,43,42,164
3251,56,42,43,43,184
4432,19,84,45,57,205
4852,47,62,36,34,179
7973,36,7,55,43,141
6328,39,57,58,55,209
2078,47,28,64,43,182
3116,73,46,51,58,228
5940,54,58,35,64,211
730,33,65,25,58,181
8528,26,37,60,28,151
6484,22,44,34,51,151
5226,59,24,57,37,177
1906,49,35,55,44,183
7404,60,44,56,62,222
1880,35,58,54,50,197
1471,75,53,61,40,229
484,60,60,64,63,247
6071,72,71,9,69,221
8501,56,46,25,46,173
3432,43,53,66,31,193
5599,46,51,39,57,193
7575,67,24,35,62,188
6676,88,52,54,52,246
6166,27,44,36,53,160
8491,56,50,46,51,203
6732,75,46,77,45,243
5555,65,33,44,62,204
9254,51,46,38,50,185
8507,55,54,37,19,165
1278,37,80,35,54,206
7379,60,71,61,69,261
8377,24,31,51,55,161
4862,54,72,71,50,247
1386,41,61,67,14,183
474,36,42,38,61,177
4366,59,24,35,59,177
838,86,72,41,35,234
9458,61,71,58,74,264
4879,60,61,33,25,179
7472,49,43,67,66,225
4883,50,63,33,69,215
6997,34,55,36,59,184
9191,52,62,27,32,173
6380,43,100,52,53,248
9474,68,51,77,38,234
6695,83,81,44,30,238
8841,41,66,34,61,202
8691,48,53,60,65,226
6271,59,21,31,49,160
9663,57,74,68,41,240
9418,44,39,53,44,180
3804,35,64,39,54,192
4688,44,52,39,48,183
811,68,31,50,57,206
2416,39,37,39,54,169
8593,58,71,36,34,199
9416,56,49,65,62,232
7055,39,51,48,71,209
6002,28,64,49,71,212
3020,49,56,53,34,192
4051,61,38,40,35,174
7686,30,53,73,16,172
5274,43,64,63,62,232
7061,61,28,75,44,208
4514,60,21,70,51,202
7194,55,86,60,64,265
5927,48,29,70,45,192
8749,59,30,61,72,222
2478,58,63,52,22,195
8290,72,74,44,61,251
372,37,21,76,6,140
5547,56,70,40,42,208
479,53,52,45,36,186
3530,26,60,64,45,195
3381,36,39,21,33,129
6185,68,44,36,44,192
9801,58,31,49,41,179
7908,56,33,61,38,188
3887,40,52,25,43,160
2915,31,56,52,45,184
4226,66,46,58,32,202
9950,51,41,62,67,221
9732,43,45,31,41,160
3112,51,49,65,75,240
7363,56,58,46,84,244
7932,57,21,63,41,182
2358,33,46,48,39,166
9364,55,71,56,63,245
4178,63,53,46,61,223
5678,55,53,49,48,205
1558,47,57,50,66,220
8536,55,54,66,13,188
9006,53,72,35,45,205
8917,59,42,61,35,197
1591,77,60,42,53,232
8809,55,69,45,64,233
6124,53,58,67,67,245
9836,48,41,28,55,172
1092,52,68,72,52,244
8972,61,50,61,55,227
684,59,35,29,44,167
1100,59,80,46,53,238
3551,31,47,47,59,184
6096,54,38,52,58,202
3663,53,25,57,51,186
5649,57,22,51,36,166
2850,52,37,44,70,203
7417,74,88,42,65,269
5590,75,50,46,59,230
939,35,30,51,49,165
6714,35,44,60,67,206
2881,36,50,84,46,216
2996,54,54,63,41,212
8219,30,60,39,51,180
6091,63,50,75,37,225
6596,38,47,42,49,176
3371,75,40,63,62,240
6296,47,52,81,48,228
7912,74,65,34,52,225
9398,80,59,49,37,225
5476,54,51,34,52,191
8900,51,50,38,52,191
965,60,86,17,47,210
7040,35,56,52,57,200
1887,20,58,77,75,230
4698,54,35,47,45,181
7714,43,67,30,36,176
6769,71,36,27,49,183
3157,78,16,31,73,198
1434,45,58,63,32,198
4978,45,50,48,38,181
4316,75,48,33,35,191
3840,63,43,49,23,178
4593,52,75,70,52,249
1840,29,65,16,62,172
5992,48,83,71,54,256
1744,55,39,36,58,188
4761,34,57,59,65,215
9540,39,46,57,38,180
6685,57,34,61,23,175
9607,52,53,69,25,199
5496,62,62,56,31,211
4094,60,51,44,48,203
738,65,75,53,48,241
7162,57,95,43,44,239
5712,47,70,36,48,201
3263,49,35,68,56,208
6372,46,55,55,42,198
9830,39,73,53,57,222
9252,72,62,53,45,232
185,50,67,55,77,249
8292,31,43,52,22,148
3640,37,52,39,45,173
802,58,35,60,61,214
3410,69,55,58,63,245
7191,66,61,72,72,271
4583,50,34,56,64,204
5872,47,34,72,62,215
8906,22,89,59,61,231
2324,43,38,30,72,183
3098,34,44,18,23,119
1087,38,93,49,58,238
4703,49,38,54,45,186
1156,55,37,63,46,201
4705,38,29,39,45,151
3242,65,49,67,29,210
6123,58,22,33,32,145
7353,36,43,27,45,151
830,35,59,46,46,186
8468,47,51,32,54,184
8633,44,36,23,65,168
5707,45,53,35,30,163
5305,68,54,61,54,237
8515,40,60,27,27,154
208,47,37,37,48,169
8465,28,32,61,42,163
8385,50,67,61,9,187
8295,44,41,42,41,168
9650,46,44,59,64,213
5190,56,86,76,56,274
5562,16,2,50,51,119
6664,42,44,21,70,177
6712,69,47,0,50,166
6232,43,18,62,12,135
6334,24,31,40,37,132
894,45,33,42,56,176
3998,28,65,56,51,200
5192,50,35,71,59,215
347,50,59,84,38,231
6795,26,59,43,60,188
3925,42,46,31,23,142
2514,53,72,45,51,221
4907,51,34,52,31,168
6342,57,61,38,60,216
6829,32,48,54,36,170
9376,64,31,60,39,194
646,26,60,56,22,164
1157,55,24,27,67,173
5488,54,56,71,57,238
5398,17,59,70,37,183
5141,49,56,52,44,201
6570,59,36,26,47,168
1293,18,23,35,49,125
1956,44,35,65,51,195
7433,60,46,54,42,202
4959,39,61,50,67,217
2572,44,77,48,46,215
8813,74,35,10,75,194
3513,59,21,52,68,200
2534,37,46,46,59,188
1903,73,25,36,47,181
7573,31,25,18,49,123
2820,78,51,24,65,218
6958,62,74,59,56,251
3536,29,27,32,53,141
9471,24,28,45,58,155
1935,54,56,55,7,172
160,27,43,48,63,181
7510,50,18,48,30,146
1202,37,60,58,52,207
4187,27,25,26,61,139
9088,49,79,51,60,239
471,39,59,44,68,210
1412,35,68,46,66,215
6532,42,36,65,57,200
8612,44,37,57,63,201
7935,47,53,46,59,205
9368,28,43,46,62,179
2434,64,47,89,35,235
6461,60,70,39,51,220
4559,75,50,28,42,195
333,55,50,56,65,226
5101,39,69,50,21,179
181,47,40,52,81,220
2756,55,60,45,62,222
6597,56,91,77,50,274
5809,61,17,47,65,190
6841,52,58,67,19,196
6751,26,30,59,32,147
4351,42,79,55,37,213
9160,84,23,58,13,178
2083,69,60,63,34,226
9834,56,51,69,38,214
4621,27,56,44,68,195
4881,24,51,38,40,153
5858,59,38,41,38,176
6299,28,58,62,32,180
4944,36,59,75,61,231
2100,41,41,27,34,143
1992,84,52,59,65,260
9309,25,37,42,18,122
9429,89,83,66,46,284
3864,45,53,55,52,205
7821,59,49,45,65,218
2294,46,73,52,56,227
4732,53,51,38,55,197
28,33,20,71,40,164
2439,44,58,59,78,239
6885,53,39,39,50,181
4346,33,69,51,46,199
6549,91,42,20,65,218
5013,80,49,53,83,265
2360,52,47,63,46,208
9796,40,55,51,49,195
31,59,48,47,42,196
493,25,53,51,52,181
8109,51,43,47,39,180
8349,13,45,41,77,176
6401,59,64,74,61,258
4013,58,44,63,51,216
6199,47,68,38,45,198
2522,71,65,55,40,231
2851,76,6,10,57,149
8968,44,44,45,47,180
4730,20,27,58,66,171
1205,59,58,71,54,242
3354,73,59,30,44,206
7221,42,35,39,48,164
4913,59,44,27,32,162
3712,56,40,81,45,222
3774,36,28,81,35,180
3016,54,69,40,15,178
898,29,40,44,36,149
1192,56,46,45,49,196
5082,62,46,71,72,251
1262,31,37,42,71,181
8881,46,27,68,43,184
2979,54,40,85,44,223
5327,54,42,45,55,196
7448,78,42,63,53,236
7786,76,34,58,53,221
1664,54,62,72,54,242
3854,32,34,38,39,143
978,40,87,57,39,223
9943,42,43,14,49,148
5242,20,54,53,39,166
8110,70,56,53,28,207
9250,36,62,65,57,220
2585,55,36,67,43,201
610,47,65,32,47,191
4393,54,38,63,35,190
9577,61,59,51,41,212
9051,67,48,33,44,192
3498,51,71,48,41,211
5168,32,69,56,53,210
8535,48,58,44,82,232
3773,42,83,48,42,215
9031,64,60,37,28,189
1057,38,49,41,40,168
8434,42,59,64,59,224
1463,31,58,70,60,219
3428,55,23,61,49,188
3557,50,58,58,52,218
1662,54,50,70,67,241
4719,62,44,32,57,195
4031,49,44,81,31,205
9904,70,71,52,58,251
7929,67,50,40,47,204
307,43,57,56,55,211
5972,69,79,30,26,204
1898,29,53,50,36,168
5193,46,18,59,34,157
7862,35,82,25,19,161
9710,49,44,81,70,244
849,37,55,60,62,214
6735,39,51,43,75,208
3397,42,39,73,47,201
9703,39,62,30,36,167
4383,32,18,55,58,163
2381,45,42,71,21,179
5745,49,32,38,84,203
7002,31,49,62,68,210
1091,48,57,61,51,217
2949,41,29,64,41,175
8370,38,30,53,42,163
3167,49,44,47,45,185
270,44,55,32,60,191
1931,53,40,46,51,190
7963,60,26,54,13,153
2524,63,46,33,64,206
1430,43,64,17,33,157
806,63,66,38,42,209
9171,9,71,38,53,171
6206,63,41,55,69,228
8348,37,59,27,45,168
4493,48,79,44,49,220
3220,78,65,72,43,258
7176,58,25,53,80,216
5761,65,42,67,38,212
6441,74,46,64,45,229
722,43,53,85,42,223
4831,70,72,39,23,204
7172,64,55,45,36,200
6692,65,41,46,62,214
3627,53,64,81,70,268
7914,32,37,59,30,158
1502,43,55,20,58,176
8023,47,71,85,49,252
8736,59,60,71,82,272
8526,71,69,44,50,234
1588,45,86,74,39,244
4099,26,45,49,53,173
4768,25,44,53,66,188
8425,43,41,38,72,194
317,42,25,75,71,213
9279,77,43,62,42,224
8922,28,51,51,47,177
5683,14,44,49,29,136
8686,51,69,61,48,229
6144,58,37,61,35,191
4466,55,40,52,74,221
5558,49,55,42,51,197
8419,49,45,41,35,170
1220,60,64,59,32,215
3618,33,61,51,68,213
7768,27,66,56,46,195
2951,42,83,27,26,178
8040,31,16,16,23,86
7093,66,50,39,54,209
3635,77,7,53,43,180
6490,65,72,32,78,247
6872,57,41,41,51,190
567,49,44,42,59,194
2276,36,66,16,27,145
767,48,78,58,55,239
5984,64,17,65,71,217
8360,40,40,58,52,190
3698,69,70,48,52,239
6013,36,42,72,19,169
5061,54,37,53,51,195
123,47,60,55,65,227
9271,65,39,65,24,193
3646,61,31,80,49,221
26,44,48,43,53,188
6800,59,53,69,67,248
3070,43,48,43,40,174
9422,60,30,50,46,186
8757,81,15,26,53,175
9873,58,38,38,64,198
6075,32,42,29,42,145
2467,48,39,64,27,178
1817,52,22,45,55,174
9056,54,65,65,71,255
1394,25,34,66,55,180
6861,35,33,47,71,186
3622,67,35,51,56,209
7997,37,22,53,39,151
3036,17,61,47,50,175
8187,37,47,74,45,203
7250,77,51,59,77,264
9878,46,74,62,47,229
8039,30,61,46,52,189
4243,52,56,54,53,215
4317,58,35,24,19,136
5509,56,23,46,39,164
7594,65,68,67,49,249
7548,81,67,48,21,217
1435,40,13,51,33,137
3947,47,47,32,40,166
2237,48,41,29,27,145
6054,77,60,65,60,262
6404,40,62,40,61,203
7279,52,29,65,42,188
1231,47,23,65,48,183
7709,59,61,50,42,212
3987,39,41,73,43,196
3175,54,35,48,51,188
8369,51,56,47,48,202
5439,74,30,47,56,207
2625,56,66,64,39,225
9941,57,55,78,70,260
657,67,48,79,26,220
4441,67,61,62,60,250
1684,49,42,46,32,169
1410,24,71,56,50,201
658,10,78,58,49,195
9332,26,25,78,74,203
3484,26,39,63,65,193
2961,27,76,21,65,189
8630,29,54,75,30,188
1512,40,32,43,55,170
8485,65,43,67,34,209
1397,98,37,62,38,235
9653,72,46,66,44,228
2010,59,57,68,43,227
8636,64,54,51,58,227
5359,59,19,64,56,198
340,19,52,47,19,137
8787,40,65,46,43,194
1629,28,35,37,60,160
8320,68,61,72,31,232
9790,41,67,54,51,213
1889,45,63,40,49,197
6391,45,21,63,85,214
889,47,89,62,46,244
1123,44,53,43,60,200
7182,66,35,49,70,220
8859,42,57,75,73,247
833,61,41,66,36,204
7065,77,69,53,31,230
6671,68,25,72,80,245
8198,27,63,46,57,193
4010,68,39,58,41,206
9260,64,47,13,50,174
3643,38,48,47,56,189
6004,34,56,72,42,204
7323,46,45,30,57,178
8544,42,40,48,58,188
2512,36,48,68,44,196
944,26,54,38,32,150
4655,66,51,50,61,228
7350,33,94,74,51,252
6172,58,34,60,42,194
5175,25,54,67,56,202
5754,40,48,47,22,157
4942,72,37,50,79,238
607,60,77,58,49,244
5559,53,71,37,65,226
2646,35,31,60,76,202
6865,53,66,68,32,219
487,59,67,84,55,265
7080,50,53,44,41,188
384,74,68,28,49,219
8185,57,31,70,66,224
4718,52,39,49,76,216
3336,52,35,28,40,155
2954,51,32,50,29,162
7193,48,51,51,44,194
4282,53,44,37,53,187
4846,46,21,64,36,167
1619,59,39,33,68,199
4026,53,41,39,25,158
4156,56,28,48,42,174
9874,73,28,72,69,242
462,61,48,63,47,219
7770,80,46,53,52,231
5794,56,63,67,47,233
6175,46,31,21,51,149
3827,80,40,49,61,230
7968,24,37,37,26,124
3278,58,65,46,49,218
1895,65,41,54,49,209
2111,58,52,64,49,223
8678,30,32,24,42,128
1872,41,53,19,35,148
9917,48,45,38,49,180
6316,34,43,52,51,180
9875,60,44,34,49,187
4960,41,25,46,54,166
2215,55,67,24,56,202
2217,83,36,30,64,213
1784,72,68,30,63,233
6555,63,74,30,40,207
4361,55,54,62,59,230
632,71,39,30,49,189
5870,66,54,40,52,212
791,61,47,30,66,204
4352,56,59,16,52,183
8212,30,66,51,48,195
3766,64,40,58,61,223
2223,41,62,71,48,222
3384,34,44,54,54,186
1312,29,28,17,49,123
5424,48,53,44,22,167
7891,59,27,52,40,178
1605,42,67,46,72,227
3898,34,40,58,26,158
539,54,55,70,24,203
5823,42,74,33,67,216
7165,50,68,57,43,218
1044,56,61,36,40,193
2243,49,29,69,66,213
2803,40,36,61,38,175
2601,32,38,62,52,184
4659,51,41,28,27,147
3788,28,22,43,61,154
8277,55,33,83,48,219
6043,42,46,42,38,168
357,39,35,48,35,157
4670,59,35,47,48,189
3270,44,46,44,72,206
1919,35,51,59,43,188
4247,57,67,27,53,204
546,41,59,50,48,198
8208,31,59,37,51,178
4270,26,41,36,68,171
5641,72,73,30,59,234
3125,34,42,45,54,175
3424,33,75,71,48,227
2265,49,58,73,62,242
1938,66,40,30,29,165
2353,44,38,27,32,141
614,63,25,46,54,188
9348,60,60,38,28,186
8570,21,43,34,41,139
5844,51,52,71,48,222
8771,44,14,34,85,177
7894,22,50,50,59,181
8551,44,2,36,56,138
7948,45,48,50,29,172
3051,84,50,60,50,244
7529,33,39,28,58,158
5797,46,48,32,48,174
8638,52,42,38,22,154
5260,33,62,64,35,194
7860,52,48,26,41,167
5285,54,48,57,67,226
5384,35,46,60,51,192
5247,36,47,43,47,173
5389,42,26,56,11,135
1305,49,63,47,27,186
5778,58,66,42,36,202
6774,71,12,43,69,195
9356,60,16,50,52,178
1144,55,31,29,44,159
3582,47,86,23,37,193
1879,46,71,70,46,233
571,52,54,45,71,222
2440,55,35,47,57,194
7262,43,42,56,52,193
3953,37,57,50,20,164
7918,61,67,31,69,228
1354,42,80,95,23,240
117,35,40,31,72,178
147,65,34,76,55,230
2807,55,37,45,35,172
7977,76,27,47,61,211
406,51,33,66,36,186
7418,49,46,60,44,199
73,62,45,71,51,229
4398,69,48,60,87,264
7415,50,61,59,63,233
388,31,41,59,29,160
5302,21,37,48,34,140
2790,26,46,76,46,194
3047,35,32,56,55,178
861,28,53,17,30,128
1407,67,32,29,50,178
4019,71,57,49,41,218
1408,44,54,27,45,170
5603,52,44,38,63,197
6399,59,53,45,44,201
3556,68,38,34,50,190
6516,59,72,30,59,220
7238,70,61,52,12,195
7743,51,62,44,45,202
8905,0,64,40,39,143
5127,43,23,39,38,143
7092,34,48,55,59,196
7539,68,49,54,57,228
1962,61,32,39,49,181
1900,48,17,43,41,149
2674,84,39,56,55,234
3294,51,65,77,32,225
3678,38,80,64,27,209
8786,40,32,32,34,138
3587,40,83,58,50,231
5184,61,57,79,72,269
2541,57,22,38,49,166
972,68,56,67,26,217
9828,0,23,56,69,148
7300,45,91,37,51,224
6612,44,81,96,54,275
4016,35,60,64,56,215
6117,77,1,50,52,180
4560,51,66,44,35,196
5792,38,45,58,66,207
7944,52,58,45,43,198
6835,46,30,40,51,167
4106,45,55,58,29,187
8030,36,14,48,50,148
6903,51,24,16,69,160
5741,56,72,42,21,191
2711,56,57,56,51,220
5885,58,32,21,60,171
7922,71,40,57,64,232
8325,44,73,49,34,200
4812,51,70,46,58,225
7159,29,29,35,76,169
2717,47,51,41,65,204
7251,39,76,31,45,191
745,12,57,26,33,128
9315,51,45,44,47,187
4605,70,63,48,27,208
3487,60,50,34,44,188
8300,30,47,72,73,222
6502,28,62,67,52,209
2732,51,35,23,18,127
3327,53,53,39,58,203
5383,21,49,49,29,148
7443,54,37,54,46,191
674,72,55,34,40,201
6252,50,43,63,58,214
8820,64,46,54,35,199
7052,56,58,38,74,226
2680,33,58,60,59,210
8357,47,33,72,4,156
9913,36,66,46,58,206
1922,32,59,61,73,225
8407,48,51,50,37,186
3933,33,12,45,39,129
4642,49,48,27,54,178
1623,63,48,77,45,233
3228,52,51,40,57,200
3417,42,41,39,68,190
4977,72,64,59,41,236
1197,54,45,47,36,182
5660,51,71,76,24,222
9961,46,29,60,64,199
6781,58,25,48,35,166
2200,51,55,49,36,191
4570,48,57,28,26,159
8963,32,70,54,55,211
343,27,71,65,73,236
3540,37,60,25,70,192
207,26,35,55,43,159
6487,39,50,31,52,172
9812,74,30,48,51,203
6991,52,54,42,75,223
6542,44,43,28,57,172
3092,61,60,29,66,216
4565,68,46,74,29,217
9410,46,42,41,58,187
1808,56,54,39,25,174
9484,30,51,14,48,143
3096,33,51,48,25,157
7485,55,46,44,30,175
2154,49,31,45,54,179
3065,56,71,79,50,256
2220,66,30,57,60,213
1137,68,23,73,61,225
7299,56,13,80,55,204
6967,28,51,58,46,183
9358,64,58,59,25,206
4949,49,5,65,67,186
8716,77,60,56,26,219
6403,63,20,66,3,152
654,69,56,78,56,259
4427,51,52,69,60,232
4629,47,36,51,49,183
7207,59,71,45,40,215
8380,46,52,80,33,211
3060,28,76,54,39,197
4803,38,30,74,39,181
9229,29,70,34,73,206
9241,49,35,37,95,216
7180,50,59,50,63,222
2559,65,41,46,44,196
8079,54,4,27,100,185
9278,57,12,40,43,152
53,41,53,44,56,194
411,30,53,42,66,191
5340,34,56,37,41,168
2171,49,41,45,23,158
1522,20,37,57,38,152
7352,77,25,29,34,165
504,30,69,68,37,204
9219,51,43,24,67,185
4909,67,58,56,79,260
7046,86,0,64,46,196
6662,0,44,48,38,130
2139,47,73,29,41,190
7358,42,56,36,30,164
5149,70,31,54,64,219
5795,36,36,57,68,197
332,43,59,71,68,241
35,55,38,49,74,216
7879,51,49,51,44,195
9189,39,36,37,64,176
327,67,63,88,33,251
1524,44,63,49,53,209
5387,56,33,42,52,183
7475,41,46,46,61,194
4876,54,65,48,38,205
9225,66,70,51,77,264
9727,31,57,64,61,213
4902,32,48,39,49,168
6643,23,65,48,35,171
3648,25,35,52,51,163
6875,42,58,37,55,192
76,34,30,42,23,129
576,61,55,8,41,165
4118,63,62,44,80,249
9569,44,43,35,58,180
4137,35,48,41,66,190
1646,80,73,34,66,253
107,37,46,37,28,148
8746,41,35,72,33,181
4304,63,27,38,26,154
8235,52,70,58,53,233
4581,53,64,58,73,248
4011,52,51,62,94,259
7991,34,39,67,71,211
1108,48,44,66,83,241
2945,6,23,62,32,123
5067,24,56,38,55,173
1734,45,58,37,49,189
1244,43,64,65,64,236
6255,55,36,47,27,165
4394,53,43,43,55,194
7865,40,70,36,48,194
3829,64,26,25,73,188
5097,46,70,70,71,257
8033,54,62,7,37,160
7566,57,55,48,68,228
693,50,40,67,30,187
6325,46,76,52,56,230
3850,50,57,68,75,250
5377,31,44,62,62,199
7428,34,54,49,55,192
960,38,19,49,60,166
2213,73,55,65,26,219
776,75,25,65,41,206
401,67,46,64,76,253
6646,39,40,62,39,180
5021,76,57,14,39,186
6432,64,44,48,65,221
9495,50,73,56,29,208
5131,56,74,47,45,222
3443,52,40,74,62,228
3006,57,57,39,62,215
9979,26,49,25,71,171
9090,78,28,42,34,182
3032,56,21,76,57,210
5550,48,93,74,61,276
5929,59,56,55,48,218
9771,64,53,71,33,221
1348,26,75,54,45,200
2295,63,43,37,30,173
1890,24,81,39,57,201
3542,61,56,52,41,210
5722,57,57,27,63,204
2014,38,22,39,70,169
5486,53,65,11,35,164
7236,55,50,70,50,225
4080,39,39,72,48,198
8781,62,21,37,63,183
9384,58,28,62,53,201
1742,29,49,77,40,195
8231,43,63,29,74,209
8417,66,55,53,24,198
716,62,48,37,37,184
4871,62,50,15,69,196
9646,3,60,57,67,187
3889,53,71,41,55,220
5262,48,62,52,59,221
4569,40,30,42,23,135
7506,37,25,66,21,149
7863,34,40,40,45,159
2256,61,39,53,63,216
2290,61,63,45,45,214
930,51,43,81,46,221
8533,31,67,77,61,236
9916,60,32,52,56,200
6874,39,43,55,55,192
1342,52,41,82,32,207
3789,32,35,45,63,175
2993,37,46,32,48,163
5946,47,32,84,78,241
4007,60,29,52,56,197
478,60,64,29,35,188
5780,53,51,79,56,239
4499,69,58,54,44,225
753,35,64,41,37,177
3017,85,25,60,56,226
4520,55,58,38,57,208
6794,46,48,63,69,226
1093,59,43,69,78,249
3982,47,48,36,50,181
3815,65,37,44,48,194
381,44,83,88,62,277
8272,50,23,56,60,189
5031,26,76,66,51,219
8665,51,17,62,60,190
9469,45,69,68,34,216
6820,14,48,59,67,188
4584,82,83,48,32,245
8615,74,65,45,56,240
4286,57,55,41,62,215
7517,43,40,74,4,161
2902,51,66,42,28,187
1375,67,57,42,50,216
1054,65,46,55,38,204
7230,54,55,65,61,235
7890,57,11,65,58,191
2133,85,56,46,64,251
2673,51,66,0,46,163
1548,74,66,49,55,244
4574,65,75,85,42,267
5989,49,72,48,39,208
3721,32,56,49,23,160
6799,62,70,64,74,270
9297,60,26,45,42,173
4836,35,57,51,45,188
3615,51,44,57,40,192
2087,51,48,33,58,190
4636,46,35,19,53,153
7882,43,75,48,53,219
4146,35,41,58,39,173
8642,54,93,47,34,228
6189,58,43,66,51,218
1589,56,25,37,45,163
7605,42,44,43,76,205
6029,53,69,24,49,195
8874,67,58,45,68,238
617,67,58,55,19,199
6265,22,69,54,32,177
1682,66,40,22,53,181
6974,50,45,62,57,214
566,67,79,51,65,262
3594,30,69,57,28,184
3507,54,45,55,29,183
3505,25,55,87,49,216
3515,42,52,46,52,192
7588,37,40,39,51,167
1403,38,75,49,34,196
362,49,59,50,82,240
8943,43,51,51,46,191
5657,36,72,51,39,198
1578,37,61,73,42,213
2990,40,41,59,37,177
2151,43,41,30,73,187
4127,56,19,37,36,148
3454,54,55,49,61,219
3620,56,44,50,38,188
3153,53,48,19,20,140
4253,32,43,55,51,181
871,35,52,51,52,190
1530,60,18,16,35,129
7155,80,42,42,37,201
3123,38,36,51,53,178
5902,70,55,67,65,257
1985,61,37,54,62,214
3382,81,51,77,47,256
7291,48,34,60,56,198
4458,13,20,46,29,108
164,34,37,62,53,186
5360,31,90,68,39,228
3970,61,34,53,52,200
4567,61,56,41,32,190
4679,41,65,34,69,209
8571,88,42,35,28,193
3274,50,71,74,56,251
9794,32,54,53,29,168
7984,52,63,56,31,202
1449,56,35,42,19,152
2090,52,73,33,65,223
7487,36,61,64,41,202
2334,47,45,43,50,185
873,33,57,78,21,189
9232,49,63,47,52,211
1717,56,56,54,41,207
6828,75,47,80,52,254
5597,68,64,51,39,222
4415,46,51,64,73,234
3280,34,53,52,61,200
5004,44,41,74,14,173
7822,36,67,71,54,228
737,78,67,51,48,244
1439,30,61,34,51,176
2744,44,61,81,61,247
1013,65,34,57,13,169
2779,26,60,68,70,224
5350,41,38,31,58,168
9978,38,60,43,40,181
7333,48,48,44,18,158
7764,74,41,61,49,225
1590,43,56,54,63,216
3322,41,59,61,31,192
9428,50,41,62,42,195
955,65,80,10,55,210
5758,69,39,61,48,217
4625,43,65,60,70,238
1532,72,37,49,72,230
940,55,42,66,52,215
9370,28,82,33,49,192
1804,56,31,58,56,201
130,60,71,31,20,182
1519,22,61,71,47,201
3394,81,67,57,46,251
145,37,50,66,29,182
390,51,45,58,20,174
8345,62,57,31,42,192
3235,32,53,71,17,173
813,43,73,62,43,221
2713,48,42,56,41,187
3929,37,60,54,51,202
7597,53,75,55,66,249
222,53,35,62,75,225
4939,42,41,68,8,159
9283,49,49,22,56,176
2735,53,11,23,39,126
8463,40,41,41,28,150
4563,50,28,26,43,147
6650,58,36,51,50,195
8502,35,26,38,32,131
4338,13,62,19,73,167
6042,53,42,25,62,182
8249,68,39,67,50,224
6052,51,55,61,48,215
6094,38,35,43,61,177
5701,49,61,65,50,225
7307,64,43,60,46,213
837,37,49,60,56,202
5737,33,44,33,40,150
6708,63,40,44,41,188
4604,34,48,54,55,191
3159,58,32,53,51,194
7082,41,45,53,63,202
5876,39,96,44,38,217
2262,70,48,26,60,204
1058,59,43,32,57,191
275,53,36,14,63,166
4023,57,66,57,61,241
8004,39,32,22,58,151
7521,62,59,11,43,175
729,42,24,25,57,148
7130,23,76,51,66,216
1761,31,36,31,47,145
842,47,37,67,58,209
8253,26,85,54,45,210
6212,21,36,53,18,128
6700,55,44,49,31,179
7456,58,67,73,54,252
4225,59,33,50,27,169
7104,42,65,57,59,223
8509,37,67,69,66,239
2137,34,64,84,37,219
1250,42,38,63,64,207
1783,62,40,30,78,210
298,57,72,53,49,231
4588,47,59,75,5,186
3992,51,94,37,50,232
1026,48,51,38,82,219
9021,66,72,37,68,243
2163,30,33,9,33,105
3061,45,44,42,29,160
2062,58,32,50,41,181
8184,60,40,24,48,172
7983,57,60,31,40,188
3368,59,56,32,35,182
3374,12,64,57,67,200
7649,13,52,53,76,194
126,72,57,71,39,239
4963,38,63,68,48,217
5056,74,51,73,48,246
5151,66,73,81,34,254
2012,57,53,69,10,189
2493,46,24,21,41,132
9806,39,60,62,73,234
3288,51,65,20,33,169
4888,73,77,44,40,234
7464,36,29,50,57,172
4882,45,42,72,56,215
6293,31,59,50,63,203
1308,43,48,55,59,205
2218,72,43,28,46,189
1758,46,41,49,56,192
9507,49,35,66,61,211
3918,44,16,28,48,136
9008,47,56,36,43,182
3733,30,46,50,57,183
7068,30,36,74,42,182
9718,44,59,50,24,177
9124,12,50,51,67,180
5121,54,42,45,70,211
9037,35,44,46,52,177
3727,54,56,42,38,190
1568,39,66,39,67,211
5544,31,78,70,60,239
3723,64,64,83,58,269
6873,76,59,64,67,266
7437,70,43,71,46,230
2751,24,49,71,51,195
6929,34,46,58,35,173
1994,33,71,42,65,211
6743,40,44,52,61,197
9631,26,65,56,52,199
6603,41,48,36,59,184
8639,63,97,45,52,257
2233,51,47,31,75,204
3545,45,56,59,54,214
6756,25,48,45,46,164
2093,36,42,48,47,173
5349,45,28,73,41,187
2178,65,66,19,61,211
7572,49,50,60,15,174
6915,38,47,44,31,160
5729,62,81,29,21,193
1851,66,37,49,42,194
4195,43,72,69,46,230
4131,73,77,43,27,220
536,61,36,53,53,203
7941,53,62,68,72,255
2455,67,66,2,52,187
9285,52,42,61,27,182
2061,69,61,42,42,214
7362,22,43,65,42,172
6740,4,56,44,71,175
4072,46,31,62,79,218
3562,67,48,42,53,210
2596,38,50,61,52,201
1673,63,55,63,61,242
111,43,35,49,87,214
557,69,53,29,58,209
7322,61,35,35,32,163
5979,28,35,46,43,152
1509,57,60,41,65,223
9649,65,50,48,49,212
8689,69,44,65,42,220
392,62,46,67,61,236
2513,34,69,75,46,224
5224,49,49,66,47,211
5862,35,41,62,89,227
6211,55,58,55,50,218
4818,31,33,56,0,120
3308,73,62,31,48,214
9022,55,55,21,38,169
4036,56,45,42,54,197
9414,25,13,39,27,104
1140,40,61,22,35,158
1597,46,74,52,47,219
475,29,66,77,57,229
1260,56,66,54,60,236
3956,42,57,53,37,189
761,61,63,54,49,227
720,67,41,59,56,223
3364,53,63,52,45,213
8007,53,40,18,49,160
807,46,71,44,41,202
1599,82,11,42,56,191
121,41,54,54,73,222
4640,40,42,28,72,182
3400,55,48,79,47,229
5045,82,70,52,39,243
1836,52,27,66,36,181
3101,58,56,40,31,185
4296,38,87,36,70,231
1738,43,48,57,64,212
5454,23,34,57,47,161
3287,33,42,46,49,170
9018,38,45,64,31,178
4634,28,71,54,51,204
1576,65,47,64,50,226
7084,45,18,30,67,160
9966,49,36,65,46,196
9899,68,70,42,52,232
2565,43,78,40,46,207
593,58,27,47,37,169
8128,48,38,50,61,197
1425,82,51,48,35,216
7211,40,41,77,63,221
4778,35,53,74,78,240
6477,51,68,38,60,217
6686,60,36,78,27,201
5814,42,79,67,47,235
1121,28,51,38,73,190
9964,96,59,59,77,291
2581,57,49,69,46,221
5473,64,41,38,38,181
7476,55,32,60,29,176
5911,31,17,53,39,140
8588,49,34,56,25,164
3880,14,13,31,57,115
8584,40,82,60,31,213
7385,35,46,46,43,170
5685,66,64,59,26,215
4638,87,67,32,46,232
1187,41,57,34,67,199
301,50,52,62,62,226
6362,49,63,44,61,217
7470,64,46,42,28,180
2088,61,49,41,78,229
7595,37,64,64,47,212
5077,64,35,68,56,223
5752,51,9,73,42,175
6276,34,30,62,58,184
8951,53,57,32,38,180
3616,54,46,44,35,179
773,49,57,42,26,174
7747,41,24,50,75,190
2293,59,26,56,28,169
819,47,63,28,59,197
9948,51,40,12,67,170
9929,44,69,53,18,184
8981,42,44,62,12,160
3008,74,41,46,63,224
6191,37,45,48,48,178
1915,53,49,66,80,248
310,41,50,44,26,161
1873,39,41,29,30,139
8337,46,28,55,72,201
6275,35,63,53,46,197
4506,51,51,47,62,211
5765,51,69,40,65,225
9214,54,77,76,55,262
7607,39,43,49,45,176
3552,71,63,44,82,260
7247,47,31,60,41,179
2477,65,26,37,63,191
4602,74,54,41,52,221
4148,49,55,57,67,228
5169,48,37,35,38,158
4543,67,38,15,60,180
3500,38,57,45,64,204
1454,45,59,52,28,184
6248,59,61,46,40,206
1537,58,50,28,62,198
2985,52,61,41,75,229
6945,72,75,65,37,249
2033,48,42,35,54,179
7042,46,42,59,83,230
5195,24,61,25,29,139
2882,34,42,74,55,205
5090,48,49,50,65,212
4510,51,90,50,30,221
2723,32,48,34,55,169
7674,71,84,68,54,277
2379,47,23,34,30,134
4356,27,45,30,57,159
4084,52,22,70,46,190
6126,69,46,79,69,263
7807,62,65,57,57,241
4478,48,51,46,60,205
9167,60,29,41,33,163
7037,63,36,56,67,222
2252,14,45,43,47,149
9426,57,47,50,80,234
2216,47,60,56,68,231
5157,58,50,38,55,201
1787,75,55,63,74,267
3352,76,41,47,26,190
6279,31,46,61,57,195
8565,62,54,64,42,222
5816,29,22,52,51,154
9542,45,54,64,55,218
365,36,34,61,76,207
7138,67,68,40,56,231
8864,52,55,11,47,165
5613,26,49,100,84,259
3934,47,36,53,52,188
9835,47,13,32,39,131
5018,54,33,15,61,163
552,68,56,65,39,228
2277,54,47,72,51,224
6540,30,30,56,21,137
3415,36,50,44,50,180
1117,69,56,43,25,193
3607,67,50,34,35,186
2676,60,68,68,44,240
9619,32,71,58,58,219
7815,56,68,35,44,203
7601,49,28,55,47,179
1661,41,71,37,49,198
257,22,67,53,47,189
4893,50,53,48,64,215
7554,43,47,16,69,175
3338,57,48,64,64,233
133,71,51,57,77,256
7206,52,40,35,85,212
962,60,57,34,70,221
2292,52,64,66,71,253
4390,26,44,43,63,176
5924,37,77,33,57,204
4219,66,47,50,34,197
4468,55,50,68,43,216
9891,44,25,64,47,180
8245,46,44,78,70,238
8238,74,39,76,34,223
2057,61,79,29,52,221
1806,20,39,40,50,149
213,27,57,22,53,159
2047,24,52,57,52,185
8863,54,45,42,78,219
4272,47,51,33,56,187
6045,56,56,36,38,186
2959,5,71,64,42,182
5187,52,48,72,38,210
7222,51,79,59,29,218
3,45,55,63,74,237
8801,38,60,33,44,175
2617,48,46,32,43,169
8779,32,29,58,46,165
4224,93,77,80,56,306
437,54,36,65,64,219
2483,47,40,45,50,182
1832,49,74,33,71,227
5994,12,68,40,45,165
2508,60,51,61,53,225
1907,73,60,46,76,255
369,60,68,64,27,219
8181,28,55,40,23,146
9856,46,34,77,44,201
4849,43,42,41,46,172
6120,28,73,56,41,198
7508,33,58,37,49,177
7237,79,75,25,39,218
3803,33,63,27,30,153
4953,27,27,56,44,154
2413,32,51,48,50,181
1657,61,46,65,33,205
2285,65,78,60,29,232
2540,33,51,29,49,162
7301,38,52,75,64,229
5849,71,64,18,28,181
7582,49,24,25,70,168
5055,66,73,59,51,249
5694,39,45,39,54,177
1102,36,50,61,86,233
6880,40,75,40,40,195
6975,65,47,40,65,217
667,49,34,39,42,164
8826,22,21,28,45,116
7600,70,48,86,60,264
7202,63,50,69,43,225
6724,64,17,46,65,192
3669,75,71,36,49,231
2580,68,57,54,49,228
3299,16,50,29,56,151
6222,52,65,38,86,241
6624,55,75,50,52,232
6961,46,42,42,30,160
5,36,50,53,38,177
664,64,67,32,46,209
4196,33,61,45,98,237
7154,69,66,66,41,242
609,32,55,49,57,193
4916,47,77,62,58,244
8808,50,41,40,31,162
1934,27,37,89,63,216
4085,36,32,51,49,168
3090,35,59,47,51,192
9200,39,52,23,67,181
83,54,45,64,65,228
8955,37,59,42,46,184
6051,36,43,39,58,176
4126,51,40,46,35,172
8352,44,56,37,67,204
843,63,57,52,33,205
8444,36,57,48,47,188
9884,42,48,49,49,188
3161,73,19,31,52,175
8270,35,40,57,41,173
8236,48,77,41,5,171
9741,62,58,54,66,240
3570,39,55,30,30,154
9161,55,34,35,36,160
2801,53,45,51,25,174
3679,75,62,52,40,229
5512,39,45,54,30,168
4073,49,72,65,37,223
6609,28,52,45,46,171
9721,60,59,41,54,214
2272,38,23,76,57,194
1660,48,45,71,72,236
6699,83,54,53,61,251
3916,68,42,53,58,221
3257,36,36,41,52,165
5165,32,23,30,53,138
5877,63,53,37,69,222
15,57,55,29,40,181
1925,67,45,45,66,223
4850,49,33,37,66,185
8061,48,42,43,61,194
7020,72,29,53,71,225
8583,48,26,59,33,166
6186,46,31,33,36,146
8046,48,46,34,32,160
4951,36,50,32,53,171
9133,45,35,63,57,200
2682,31,46,52,64,193
7618,72,44,81,67,264
8950,53,58,81,52,244
629,42,57,62,32,193
9388,40,35,75,58,208
6216,57,47,63,60,227
1837,53,44,49,38,184
7951,64,60,36,37,197
2006,76,51,54,56,237
6229,53,12,59,60,184
2590,45,48,73,42,208
6589,50,45,52,44,191
5884,58,64,58,73,253
6220,51,50,59,48,208
7939,62,62,58,56,238
3491,43,54,43,44,184
1299,46,88,40,59,233
3229,37,77,46,68,228
4326,32,14,45,40,131
6870,45,35,37,39,156
9647,52,48,58,39,197
6578,62,40,48,68,218
9290,70,62,44,63,239
4689,43,26,50,49,168
225,55,54,45,42,196
851,43,47,49,32,171
5282,50,71,75,50,246
2900,39,31,47,24,141
8286,30,32,70,46,178
2142,30,48,49,82,209
5181,24,67,65,66,222
7653,50,36,92,30,208
2156,61,59,69,47,236
5819,34,39,64,52,189
2278,51,46,32,45,174
3541,43,32,61,67,203
5595,39,73,29,64,205
5525,40,52,18,17,127
961,72,53,83,66,274
9705,44,40,61,19,164
1105,14,55,65,65,199
9447,51,63,52,82,248
4273,33,62,17,45,157
4474,76,38,65,29,208
7832,60,40,56,54,210
3266,32,34,31,44,141
1731,43,51,54,29,177
6138,48,54,59,29,190
8737,45,48,29,58,180
2066,59,52,69,26,206
6539,50,38,52,42,182
6087,79,78,61,20,238
8056,56,33,55,35,179
2158,58,38,66,60,222
3074,30,55,61,57,203
6198,44,29,48,78,199
7868,64,41,90,56,251
7152,55,51,63,48,217
1160,100,59,56,56,271
4169,66,37,40,40,183
3348,46,54,67,54,221
7320,13,52,67,47,179
732,42,40,34,0,116
5319,60,18,57,44,179
3683,62,42,52,74,230
6249,44,59,65,57,225
3163,62,37,29,60,188
1059,59,40,14,40,153
2662,79,19,34,50,182
5511,65,30,81,38,214
9895,24,24,54,32,134
8734,38,45,52,44,179
6070,54,51,31,45,181
9408,13,49,48,60,170
4706,60,55,55,29,199
5785,63,55,71,16,205
7480,45,68,46,51,210
338,62,47,50,43,202
3495,10,65,47,40,162
728,54,33,13,81,181
2862,19,54,44,53,170
4651,53,45,71,84,253
7571,67,51,12,63,193
6333,19,68,63,34,184
5584,49,78,51,80,258
4269,74,37,42,38,191
1680,55,63,67,42,227
2576,57,62,45,21,185
7258,57,67,58,47,229
6041,35,29,51,67,182
1070,42,40,54,79,215
2642,49,62,71,31,213
1126,54,22,46,15,137
9859,56,22,29,62,169
3479,54,61,40,32,187
2392,66,40,50,29,185
4430,39,25,27,54,145
7420,64,61,24,43,192
3283,3,23,17,32,75
3710,41,47,52,35,175
3276,41,47,58,50,196
774,87,33,53,74,247
1049,61,58,26,57,202
3029,0,50,34,38,122
3544,54,39,32,44,169
1155,96,48,32,69,245
9667,55,67,54,35,211
8356,37,50,45,46,178
9193,25,41,54,58,178
506,47,45,35,71,198
5064,51,25,24,22,122
1380,57,48,62,44,211
6310,65,51,74,37,227
2569,28,49,80,51,208
2072,41,24,50,90,205
6108,58,44,73,48,223
4233,42,71,57,53,223
173,58,33,28,50,169
3645,52,52,30,76,210
2539,34,20,57,72,183
4380,24,68,47,69,208
4404,55,35,57,51,198
5963,37,47,42,32,158
8938,62,42,25,58,187
6381,65,70,53,36,224
7345,59,32,57,57,205
151,53,51,21,91,216
3692,83,31,46,66,226
6855,56,56,33,48,193
9425,50,55,54,40,199
2172,43,25,79,36,183
2026,63,59,57,71,250
3406,63,56,55,46,220
6078,73,51,90,58,272
3241,74,27,74,50,225
2187,37,43,39,53,172
3526,46,28,30,29,133
2359,35,85,30,47,197
3465,37,39,57,43,176
2423,40,22,50,66,178
6141,45,43,19,75,182
2545,38,41,34,54,167
1542,46,57,71,43,217
2344,43,32,48,41,164
2316,54,68,41,44,207
337,59,38,37,93,227
1209,65,55,51,52,223
3279,42,65,50,60,217
2077,34,26,64,79,203
7280,87,50,72,46,255
5028,59,21,49,45,174
5053,44,36,52,33,165
708,87,51,48,73,259
3977,50,69,22,51,192
7806,35,18,49,58,160
6635,2,45,22,55,124
9132,62,49,65,52,228
5230,35,54,24,67,180
5925,16,49,70,52,187
4708,65,81,44,54,244
6608,22,45,48,34,149
2268,66,14,30,29,139
3832,45,87,48,39,219
8952,68,71,53,59,251
2977,76,52,41,49,218
6990,35,23,64,42,164
5493,42,30,49,52,173
1322,57,63,40,52,212
3475,31,69,41,63,204
5990,37,70,58,43,208
9282,76,81,46,27,230
545,84,33,43,47,207
98,50,72,48,67,237
1865,45,47,40,49,181
5629,52,62,23,49,186
3236,30,40,62,58,190
3921,59,60,49,74,242
612,34,25,65,100,224
5833,63,46,55,35,199
7896,59,52,44,70,225
5059,41,44,72,62,219
6361,69,35,34,57,195
7151,29,68,46,53,196
7656,56,67,52,56,231
9242,38,31,56,48,173
1592,31,53,44,49,177
5429,44,63,48,66,221
6423,58,46,56,63,223
9973,46,33,45,33,157
3830,56,44,62,24,186
9164,44,71,63,71,249
5240,60,64,65,44,233
6209,76,42,52,44,214
2842,55,70,53,39,217
4550,60,43,43,72,218
1451,82,40,66,51,239
4431,54,38,46,64,202
7007,48,53,38,48,187
981,54,57,60,49,220
486,22,54,63,56,195
7988,78,50,29,66,223
6482,48,53,29,47,177
3499,68,40,26,38,172
5043,70,81,53,53,257
6231,62,24,65,67,218
7265,40,69,72,34,215
6193,69,48,60,60,237
6759,30,82,24,29,165
455,53,72,61,80,266
9249,89,55,76,26,246
2419,58,47,35,44,184
8802,48,43,36,69,196
9129,67,19,92,23,201
2374,40,44,60,40,184
2831,68,10,54,54,186
9267,51,34,53,74,212
7560,51,56,52,24,183
4438,50,69,49,37,205
5985,42,28,43,42,155
7897,56,38,36,33,163
3334,36,19,76,33,164
9656,38,71,59,58,226
5568,35,52,21,23,131
4504,31,61,27,43,162
7344,79,41,39,30,189
4151,45,49,46,35,175
3704,44,58,62,32,196
6064,74,67,52,20,213
377,72,49,36,40,197
911,42,50,64,65,221
4185,10,84,58,32,184
3754,65,93,68,77,303
1713,48,76,37,42,203
8793,43,74,46,46,209
3416,52,69,63,68,252
522,30,71,38,49,188
1984,36,53,48,45,182
2177,50,31,59,31,171
5375,16,42,58,58,174
3765,47,40,27,61,175
5973,46,34,72,60,212
300,52,69,67,43,231
4801,48,28,53,44,173
4255,34,52,86,58,230
5105,52,53,65,44,214
9623,50,76,63,53,242
5074,23,44,38,63,168
920,46,43,56,46,191
5124,27,60,29,30,146
5354,57,60,18,46,181
8386,68,62,47,67,244
1296,41,37,38,44,160
6400,40,34,87,60,221
1706,84,27,44,61,216
2338,44,59,72,50,225
7015,27,32,31,35,125
1078,44,29,33,25,131
8990,40,51,43,39,173
6985,53,64,46,59,222
9785,51,43,38,47,179
2327,49,32,52,14,147
4333,11,31,52,41,135
1876,31,39,34,65,169
7017,44,64,58,58,224
547,84,27,51,58,220
2321,32,28,67,36,163
9190,49,78,17,50,194
9666,61,42,60,42,205
8351,55,32,29,51,167
4388,46,62,67,71,246
2135,25,68,30,42,165
5747,42,28,26,73,169
7427,66,62,40,26,194
6832,39,41,41,41,162
941,40,55,27,46,168
2913,62,46,65,19,192
1930,40,27,44,72,183
2475,48,39,51,51,189
6446,70,37,52,67,226
9777,72,39,39,61,211
5953,39,53,56,51,199
170,48,34,66,44,192
8092,45,59,64,54,222
3900,64,95,39,43,241
3289,77,53,84,71,285
4216,59,40,43,53,195
8403,77,64,49,34,224
7526,76,62,55,35,228
5609,27,66,63,55,211
661,75,44,35,48,202
1402,28,50,39,52,169
1933,56,63,43,42,204
3346,41,84,60,39,224
6467,58,44,33,72,207
3203,42,40,24,61,167
6028,57,37,63,60,217
9578,69,56,77,24,226
9695,87,76,26,71,260
99,68,44,50,52,214
6142,36,67,46,52,201
2525,38,35,73,34,180
3170,73,2,86,44,205
3755,82,39,42,69,232
4564,69,40,69,55,233
1978,61,39,57,21,178
8658,31,42,61,58,192
5977,47,72,48,51,218
9603,25,48,40,44,157
9415,55,34,57,63,209
9215,58,27,27,68,180
9677,45,58,67,60,230
9850,44,38,28,63,173
2447,67,22,29,56,174
9497,68,65,53,67,253
2255,57,27,24,65,173
470,6,64,54,60,184
84,68,39,67,55,229
8179,53,56,31,62,202
6246,42,56,58,39,195
9509,73,28,44,47,192
4337,39,29,42,35,145
3076,49,54,57,60,220
6360,37,42,45,41,165
707,25,52,42,28,147
8472,23,69,40,37,169
2526,74,57,47,58,236
4868,39,76,9,56,180
3290,23,76,65,45,209
3599,47,51,55,39,192
9825,59,44,58,31,192
6145,80,29,57,68,234
2167,44,74,50,61,229
2227,17,57,37,49,160
4704,46,53,66,48,213
1874,32,39,38,56,165
8266,45,86,29,55,215
9712,44,54,35,32,165
2791,44,45,47,51,187
8776,38,28,74,63,203
70,62,47,63,44,216
2860,65,49,56,47,217
4498,20,28,65,48,161
3881,56,50,52,39,197
2274,53,40,36,53,182
4149,26,78,60,17,181
236,22,85,70,39,216
1753,51,64,52,36,203
339,56,59,59,47,221
6773,72,40,53,63,228
282,41,50,90,38,219
2644,47,59,41,32,179
8036,80,71,56,36,243
9529,38,33,71,44,186
6711,58,68,54,23,203
2573,17,56,44,39,156
1540,71,45,25,34,175
2618,31,29,28,25,113
5922,28,38,71,65,202
3202,68,64,46,58,236
9863,18,70,52,60,200
4526,3,69,68,48,188
7671,50,44,78,36,208
6922,52,63,59,89,263
290,41,62,56,53,212
4652,53,34,17,69,173
1149,51,75,72,61,259
7178,46,33,58,55,192
3402,18,35,43,46,142
408,55,50,44,28,177
129,37,48,51,58,194
7788,33,54,51,44,182
2720,40,49,47,71,207
6917,70,55,39,41,205
5939,45,53,40,51,189
3962,0,36,36,57,129
7528,60,62,71,74,267
3200,36,46,41,42,165
3690,60,52,59,27,198
5560,50,51,48,23,172
3596,45,53,32,54,184
7516,56,60,18,47,181
2490,61,47,70,33,211
7798,37,57,62,73,229
8654,47,46,35,48,176
6768,43,67,60,80,250
6666,43,51,43,52,189
4795,51,27,36,71,185
1316,34,67,92,53,246
4276,33,57,35,81,206
7063,26,48,50,62,186
8396,68,54,58,43,223
8314,58,87,80,61,286
3188,32,47,65,49,193
7425,32,56,54,46,188
8735,37,71,11,38,157
5390,14,52,55,36,157
2941,30,89,67,18,204
5713,60,50,46,55,211
9435,75,50,60,77,262
569,55,27,55,74,211
1722,60,61,29,49,199
4675,31,45,61,22,159
9399,48,55,34,33,170
2686,65,39,49,15,168
203,67,43,59,53,222
152,48,55,44,45,192
229,66,35,46,26,173
7296,52,69,62,70,253
5891,61,56,82,49,248
3407,74,45,66,45,230
3442,57,49,69,49,224
3756,36,71,65,58,230
3150,42,84,62,50,238
6395,59,46,56,38,199
3912,46,52,43,70,211
692,50,67,56,35,208
7388,27,50,67,44,188
2049,46,60,45,55,206
6576,25,60,54,35,174
8892,85,54,48,74,261
2397,62,89,52,35,238
4236,45,65,41,35,186
9583,39,43,54,45,181
5254,24,34,85,66,209
5176,31,39,58,38,166
7799,63,46,59,33,201
1130,50,50,0,60,160
4517,67,30,45,81,223
7861,34,32,67,76,209
2940,78,57,39,38,212
5180,64,32,82,45,223
3271,52,43,55,35,185
6620,36,57,63,64,220
1450,75,37,47,59,218
215,34,47,88,24,193
516,26,72,56,70,224
4744,53,32,46,52,183
3578,37,32,74,68,211
8744,46,48,45,64,203
4738,31,32,32,54,149
4479,34,40,45,79,198
1007,67,54,40,68,229
7670,31,76,58,33,198
1805,70,41,39,62,212
3468,14,39,51,83,187
8276,90,28,28,69,215
7982,74,39,64,76,253
446,37,52,62,54,205
7384,53,58,40,46,197
9143,57,50,53,40,200
7053,38,51,31,33,153
5364,44,64,49,22,179
5466,44,19,66,36,165
9179,57,33,64,53,207
9423,44,36,36,69,185
5228,66,56,49,96,267
8087,46,20,52,61,179
6348,56,49,43,16,164
1819,73,63,44,48,228
7696,40,64,70,50,224
1579,52,17,54,58,181
926,36,56,44,42,178
7664,39,60,50,59,208
3763,58,49,65,52,224
1109,61,46,46,44,197
5832,22,45,39,53,159
8378,71,46,73,52,242
8861,59,44,60,52,215
1626,44,44,36,79,203
3569,68,51,37,89,245
2131,59,36,26,17,138
4307,30,75,32,69,206
4860,76,57,37,42,212
4472,47,65,50,65,227
5276,73,16,46,35,170
8983,50,66,25,80,221
7308,83,63,55,70,271
9114,49,61,48,76,234
1053,46,52,33,19,150
5078,38,46,41,47,172
2991,62,45,40,77,224
465,62,44,67,37,210
5793,44,56,49,81,230
4771,49,35,53,40,177
1974,43,32,46,51,172
2080,41,74,45,62,222
2369,68,64,41,67,240
2962,33,60,34,50,177
9391,54,70,26,60,210
1801,59,52,26,55,192
7043,60,40,30,54,184
5272,39,40,53,45,177
5380,57,63,65,51,236
1372,43,54,54,61,212
8508,48,32,40,50,170
1741,55,59,9,56,179
6137,23,54,53,38,168
5815,69,66,65,58,258
3686,58,51,77,34,220
8398,38,59,86,49,232
62,38,27,48,37,150
3741,67,49,56,60,232
4606,39,25,37,51,152
3682,57,33,35,37,162
5873,52,63,59,60,234
1207,47,69,72,49,237
9839,92,41,62,46,241
9393,62,49,59,24,194
8084,88,48,45,47,228
6292,73,73,47,44,237
1601,58,51,52,46,207
668,55,41,37,57,190
6892,52,65,79,40,236
7479,54,42,53,41,190
2607,48,61,72,56,237
9510,55,39,79,56,229
1309,35,66,67,26,194
115,54,49,70,24,197
3717,52,18,25,24,119
8105,78,49,57,58,242
1990,36,28,43,66,173
1550,67,48,36,45,196
3665,29,16,55,19,119
4894,53,40,48,46,187
6285,53,62,33,48,196
4682,45,59,49,35,188
1718,68,44,59,27,198
9002,78,15,30,50,173
5205,41,86,55,51,233
656,53,71,61,54,239
9139,57,43,39,44,183
5824,85,51,49,44,229
756,48,54,11,30,143
3718,51,34,33,43,161
8569,35,45,58,37,175
948,62,38,30,49,179
2176,61,54,73,61,249
2950,22,23,39,66,150
8867,71,58,37,51,217
75,58,53,55,53,219
8893,29,29,64,50,172
7965,80,24,67,27,198
285,61,58,36,37,192
7029,64,44,58,49,215
8731,56,39,52,29,176
6434,64,42,43,48,197
6887,30,50,31,46,157
3324,56,38,33,73,200
8229,62,66,47,49,224
1617,65,47,41,43,196
1281,52,44,72,43,211
3771,59,79,55,70,263
9084,55,54,33,56,198
9782,41,69,53,60,223
6116,44,26,42,46,158
3158,31,46,35,71,183
1473,43,46,67,59,215
9770,53,29,25,36,143
3147,60,65,42,32,199
7949,17,38,30,49,134
116,55,37,15,47,154
9927,62,42,71,54,229
79,54,57,37,33,181
7927,32,27,50,57,166
1383,39,51,17,45,152
3597,57,51,71,40,219
598,57,41,22,59,179
7541,91,67,48,26,232
122,40,91,43,62,236
3259,74,74,37,47,232
3369,68,18,13,67,166
3601,56,60,62,58,236
8172,22,46,50,35,153
998,63,61,76,43,243
7769,10,33,50,37,130
6274,34,54,51,43,182
9427,54,55,45,48,202
7610,30,61,63,47,201
9236,60,43,51,69,223
8232,15,64,26,45,150
8170,53,30,85,87,255
6790,37,42,70,81,230
640,53,64,58,53,228
8072,43,44,72,45,204
7132,56,44,31,55,186
1511,58,33,31,53,175
128,51,26,46,38,161
3534,57,29,38,33,157
4600,50,76,49,68,243
4323,42,32,42,70,186
5882,67,45,58,32,202
979,84,53,54,48,239
9324,49,50,53,65,217
3312,26,53,43,65,187
705,87,72,46,40,245
6921,63,71,57,32,223
6682,65,34,30,56,185
5874,47,16,67,52,182
9550,32,48,84,52,216
2883,39,29,65,53,186
9699,52,35,56,45,188
3996,62,37,89,60,248
6523,61,52,52,55,220
3105,24,49,56,23,152
5278,55,48,55,40,198
2182,48,58,40,56,202
8178,65,51,20,42,178
5027,41,24,74,49,188
526,30,54,46,65,195
1423,36,46,45,49,176
1318,71,36,70,28,205
5446,51,60,35,42,188
1748,57,23,63,69,212
3501,64,7,58,64,193
9023,69,71,57,79,276
2410,31,58,55,33,177
9672,13,58,60,33,164
4973,54,39,53,44,190
9908,27,51,47,54,179
1486,60,35,40,67,202
7755,54,47,41,44,186
1829,60,32,58,52,202
9406,58,63,56,38,215
3886,50,55,43,39,187
5290,52,6,14,42,114
7441,45,37,47,22,151
9208,62,60,54,47,223
3225,48,52,60,64,224
579,67,48,48,69,232
8445,49,31,31,35,146
6909,56,62,64,28,210
2239,44,23,67,42,176
1024,28,38,69,19,154
6528,40,74,35,31,180
8707,57,44,58,61,220
8756,63,34,8,48,153
5589,48,68,59,27,202
1198,56,53,30,33,172
6489,52,51,70,43,216
6373,46,46,44,70,206
8183,32,33,50,83,198
6618,48,53,53,39,193
1116,61,46,48,44,199
2668,54,48,58,71,231
577,43,65,43,59,210
921,59,69,64,27,219
4904,32,43,39,71,185
3568,45,67,45,23,180
1277,46,74,27,73,220
9566,55,82,37,25,199
4840,67,39,19,42,167
8048,58,59,41,21,179
973,33,44,36,20,133
7703,48,43,71,78,240
9030,66,22,28,62,178
8090,76,67,64,69,276
2823,36,65,63,46,210
1531,44,39,64,36,183
5100,36,38,70,35,179
5594,64,58,54,47,223
4646,51,41,65,53,210
1433,38,44,21,42,145
466,41,50,73,52,216
9490,74,46,30,84,234
2912,47,51,68,51,217
4171,28,54,52,69,203
4750,33,64,46,46,189
4234,53,40,78,69,240
2354,60,43,34,71,208
8632,51,52,63,68,234
9865,73,82,73,44,272
7928,61,47,53,64,225
795,45,41,62,48,196
7732,71,39,68,46,224
6617,58,42,61,50,211
2283,57,43,50,71,221
2821,86,51,36,27,200
9725,21,55,50,48,174
1638,63,61,66,46,236
7964,16,55,35,42,148
5456,35,30,30,49,144
4607,12,36,54,48,150
2942,38,85,34,56,213
5363,65,48,33,55,201
8628,66,53,48,47,214
8437,53,32,64,45,194
2405,47,45,20,52,164
780,53,42,66,46,207
9534,45,38,48,90,221
8227,36,46,67,74,223
7960,68,46,76,76,266
9246,41,47,62,48,198
825,42,30,49,57,178
1012,50,33,57,49,189
6954,91,25,60,40,216
8205,65,80,56,31,232
9980,47,54,56,67,224
3805,63,49,38,38,188
9951,55,43,29,38,165
1679,61,54,50,30,195
3932,60,44,63,40,207
302,47,50,45,65,207
9203,74,53,69,40,236
1331,55,44,60,52,211
5129,35,41,78,45,199
7445,48,46,36,85,215
6058,50,40,18,47,155
8158,27,32,63,81,203
9095,41,83,65,40,229
831,47,49,49,85,230
7311,60,40,56,45,201
1442,66,42,29,43,180
8146,31,18,58,41,148
9038,46,42,67,59,214
696,56,39,76,36,207
8948,63,32,43,41,179
3593,45,68,33,61,207
700,50,40,44,45,179
8159,50,70,83,61,264
1188,56,39,73,75,243
2671,30,51,68,30,179
8944,37,46,23,52,158
8572,12,43,60,47,162
7999,43,43,34,30,150
7035,73,50,41,56,220
3393,49,53,47,28,177
3335,52,45,51,46,194
6085,63,64,55,69,251
4408,81,45,46,52,224
2212,29,54,42,49,174
5300,71,43,61,61,236
6127,50,42,34,89,215
6602,56,31,85,49,221
7349,53,41,60,65,219
67,96,77,34,60,267
4656,61,51,64,51,227
7568,82,37,62,31,212
4713,55,67,57,33,212
1424,19,35,60,47,161
7051,11,59,35,46,151
1045,56,52,32,50,190
1683,23,63,53,60,199
602,51,68,49,43,211
4239,43,70,33,20,166
9563,28,55,36,73,192
4002,68,48,23,50,189
8994,62,43,47,40,192
9719,31,38,48,37,154
5297,41,41,28,35,145
6998,34,27,41,42,144
5239,33,17,54,48,152
6888,29,47,50,71,197
4457,47,53,44,50,194
9767,54,72,32,23,181
1663,34,29,69,40,172
9779,25,53,66,85,229
9946,57,12,49,42,160
6114,42,47,40,73,202
865,60,76,34,66,236
7329,65,52,40,47,204
2726,62,50,59,71,242
1170,69,35,43,63,210
6753,43,60,51,26,180
7209,19,56,47,68,190
3022,14,43,36,49,142
5949,41,56,71,79,247
6295,46,93,36,35,210
3930,43,35,39,58,175
5546,55,49,59,45,208
8667,74,44,53,75,246
5229,44,72,58,62,236
1730,62,34,40,73,209
3474,59,52,57,58,226
4910,29,41,66,76,212
7075,45,42,35,42,164
9080,75,70,51,63,259
7909,66,26,48,53,193
9914,55,39,57,52,203
7975,39,56,24,51,170
8466,67,36,36,20,159
3211,60,41,50,29,180
1697,60,47,52,50,209
743,52,27,43,41,163
6326,24,72,47,73,216
3232,41,64,42,49,196
5673,34,46,32,51,163
7121,38,33,73,46,190
1606,41,59,50,34,184
2144,74,37,44,59,214
8660,53,51,78,80,262
1667,60,45,61,46,212
990,44,41,38,45,168
6492,31,53,91,73,248
7108,59,84,60,64,267
5188,61,27,48,59,195
330,60,81,55,45,241
4968,21,29,36,56,142
8773,71,64,54,24,213
8486,76,19,36,38,169
9769,52,33,35,83,203
5477,45,43,51,36,175
7261,37,32,37,32,138
3068,48,43,50,49,190
3341,51,18,61,35,165
6093,28,53,62,56,199
1830,36,36,48,60,180
1700,40,67,70,28,205
5159,59,65,53,46,223
9424,65,66,71,57,259
6445,37,75,29,44,185
7305,28,39,32,53,152
2651,38,68,42,49,197
102,61,19,46,51,177
713,36,89,24,35,184
4934,31,50,59,35,175
691,59,66,47,48,220
3787,56,29,61,50,196
3668,35,49,58,75,217
4594,55,50,33,60,198
2008,60,47,57,38,202
7574,57,43,54,56,210
6237,62,28,32,11,133
9833,45,46,40,34,165
8663,46,58,20,69,193
4088,34,61,64,68,227
3967,79,65,33,25,202
8484,40,46,69,61,216
4075,52,61,40,51,204
3617,39,37,51,40,167
4497,37,77,57,43,214
4752,64,61,43,44,212
9464,49,29,29,68,175
7917,60,72,45,66,243
8171,44,88,36,21,189
2694,29,43,27,26,125
5118,42,69,55,29,195
8197,65,69,10,32,176
4372,51,45,40,53,189
1870,57,24,73,59,213
5108,88,30,48,49,215
6264,50,44,31,28,153
5520,78,16,15,65,174
1901,43,57,46,33,179
7106,53,69,44,32,198
2468,68,38,52,84,242
9432,36,57,54,16,163
5448,77,35,36,61,209
3941,62,55,28,32,177
8710,76,42,56,30,204
250,47,45,23,68,183
7652,72,72,89,46,279
2528,18,59,32,43,152
1241,53,26,69,43,191
9827,28,61,56,39,184
3425,82,33,52,53,220
1946,65,44,52,33,194
8374,4,71,33,34,142
701,52,7,55,84,198
8209,49,71,78,43,241
7684,56,44,35,54,189
3221,36,71,47,49,203
3173,60,38,60,70,228
5002,45,74,63,40,222
4799,59,72,37,41,209
3470,71,22,50,46,189
7199,79,45,28,59,211
4988,69,54,50,81,254
4815,50,41,78,37,206
5686,63,46,43,59,211
5136,68,87,51,84,290
7884,43,41,41,57,182
7243,55,38,61,75,229
6076,23,50,65,62,200
2498,55,43,49,12,159
8054,59,40,64,52,215
6898,52,37,65,67,221
7683,39,61,50,43,193
8347,20,39,37,28,124
3395,38,42,67,42,189
8009,44,30,64,59,197
7538,91,58,79,63,291
2481,39,49,66,39,193
635,61,28,65,57,211
4179,76,63,63,24,226
7562,42,56,26,49,173
3633,26,74,62,40,202
1181,55,45,78,47,225
6336,34,52,52,63,201
448,75,58,69,53,255
3503,74,69,53,40,236
8928,51,68,44,41,204
9350,64,60,59,66,249
319,39,33,51,75,198
5579,60,41,62,66,229
5339,57,49,68,55,229
6697,20,10,56,57,143
5038,90,29,42,48,209
3748,43,70,67,27,207
1823,90,56,61,48,255
8271,57,51,52,50,210
2663,77,92,55,36,260
8388,62,59,52,37,210
7640,24,39,25,55,143
946,62,53,8,57,180
3770,71,53,29,48,201
7383,21,56,47,58,182
6817,47,37,47,47,178
8416,31,53,46,49,179
4821,29,76,52,97,254
6935,44,41,43,48,176
5306,31,42,53,46,172
348,59,50,56,42,207
4037,67,47,36,56,206
9357,49,57,31,56,193
7169,56,28,20,27,131
3746,84,19,37,68,208
1796,69,45,59,56,229
7721,52,46,41,53,192
3337,40,35,53,26,154
4192,57,44,61,56,218
1569,78,27,47,40,192
2018,37,28,30,20,115
8755,50,61,70,49,230
8047,63,27,63,31,184
4511,44,37,62,16,159
4047,63,49,43,82,237
6394,43,28,55,39,165
2482,42,45,25,67,179
1600,60,26,73,69,228
1084,44,35,49,61,189
165,36,60,35,61,192
6077,51,71,56,22,200
6097,51,41,72,52,216
3186,19,49,32,73,173
9275,43,23,37,55,158
8883,35,49,66,54,204
1279,48,23,61,45,177
2432,61,53,82,43,239
8166,66,53,70,48,237
5659,63,52,50,49,214
6234,60,61,61,21,203
8643,62,18,61,54,195
3333,67,34,66,76,243
2193,65,49,57,50,221
1478,48,63,44,51,206
3030,54,49,45,73,221
8721,48,61,54,49,212
1631,42,37,48,46,173
3799,52,33,36,71,192
6184,22,43,36,59,160
473,41,67,96,34,238
1822,55,50,72,62,239
568,65,51,53,34,203
8450,13,58,49,58,178
5573,36,58,56,41,191
1034,33,44,48,57,182
7188,27,56,77,44,204
6978,68,62,62,37,229
2681,30,48,63,47,188
3165,66,75,43,42,226
4650,43,69,66,70,248
4987,58,67,77,46,248
608,59,72,73,57,261
3217,38,39,35,69,181
2120,60,38,33,56,187
3848,75,45,50,73,243
5211,59,31,63,64,217
9116,36,46,47,29,158
5757,50,63,60,66,239
6375,34,27,49,38,148
1593,63,58,30,43,194
483,24,49,51,66,190
2110,49,44,76,61,230
6321,45,42,47,43,177
9024,50,10,77,55,192
4554,29,61,60,65,215
9523,54,67,47,79,247
7813,52,28,45,41,166
9063,71,84,49,74,278
1702,55,23,50,49,177
9438,41,43,62,42,188
6553,62,38,40,69,209
5140,49,50,85,40,224
9715,34,25,60,58,177
7229,40,61,67,58,226
253,50,71,55,73,249
7269,42,57,44,70,213
7012,47,56,69,65,237
6953,67,59,77,53,256
6006,66,23,56,52,197
249,59,55,9,32,155
514,53,64,69,43,229
8057,50,48,40,60,198
6562,82,64,25,59,230
2065,31,23,46,68,168
9445,37,24,57,40,158
8043,63,64,33,69,229
769,49,58,58,70,235
5401,60,63,55,33,211
3527,53,47,42,51,193
1813,64,62,47,54,227
7045,49,18,55,54,176
3107,18,49,49,26,142
1743,47,64,26,68,205
9042,78,60,54,28,220
5736,34,47,37,34,152
6062,55,58,31,68,212
540,53,50,44,37,184
9576,56,50,50,73,229
7580,23,52,42,21,138
3103,55,52,47,52,206
7887,21,45,62,70,198
9807,57,67,43,28,195
9244,33,34,39,44,150
4899,42,61,41,60,204
9307,47,41,46,62,196
2366,35,52,60,37,184
9019,62,35,46,51,194
2046,37,52,55,48,192
9582,45,50,78,54,227
2443,42,41,50,46,179
1011,31,38,36,55,160
2165,82,32,57,33,204
2348,15,71,38,36,160
9976,39,65,43,41,188
8469,55,78,59,22,214
2532,80,25,77,53,235
292,55,31,61,48,195
6848,56,41,55,56,208
5257,62,74,16,63,215
5051,25,83,35,45,188
4915,52,57,35,52,196
9086,60,60,65,44,229
3446,34,31,26,23,114
4428,56,19,36,34,145
2727,27,48,47,47,169
2393,57,22,74,67,220
1724,47,38,39,70,194
3131,34,20,36,45,135
6298,52,64,68,31,215
5261,69,46,65,35,215
417,61,52,26,17,156
6931,25,29,38,39,131
4315,50,42,13,26,131
6431,39,65,70,68,242
5160,7,53,38,46,144
6343,31,39,57,49,176
4508,42,26,40,57,165
3954,17,34,53,57,161
8545,35,50,60,53,198
8591,16,38,42,35,131
935,34,43,25,52,154
7225,53,36,43,45,177
277,10,24,60,51,145
9968,58,54,73,54,239
8011,46,38,46,42,172
3725,50,39,77,52,218
3445,11,19,63,46,139
9065,48,52,43,54,197
4972,21,58,56,55,190
3730,54,80,75,63,272
3910,44,58,18,54,174
3566,32,50,56,58,196
2968,23,26,31,48,128
2554,61,45,52,56,214
7602,12,53,37,51,153
4349,29,72,65,62,228
5044,57,52,47,63,219
7596,46,58,51,61,216
3082,39,39,30,42,150
7069,35,76,39,66,216
8594,49,58,47,59,213
820,44,40,85,58,227
6266,45,55,29,37,166
4725,32,70,52,24,178
9504,55,65,47,60,227
7439,44,31,61,54,190
6809,59,73,56,41,229
6148,36,50,52,41,179
4340,23,32,52,28,135
631,37,38,38,61,174
2375,45,60,73,45,223
2748,41,37,36,44,158
6471,53,49,12,45,159
2660,27,70,31,38,166
5209,64,56,56,46,222
2955,27,50,50,47,174
4377,65,91,44,36,236
7499,63,36,44,51,194
7457,40,63,28,42,173
1720,49,38,81,25,193
5417,11,66,62,73,212
4512,83,37,49,49,218
4090,30,63,58,79,230
7398,87,40,56,43,226
4782,58,58,61,28,205
442,44,43,33,43,163
1594,47,93,42,37,219
855,36,39,47,34,156
7878,38,66,75,43,222
1234,62,27,41,70,200
453,46,57,36,48,187
9185,72,61,66,36,235
9075,27,47,42,15,131
1699,38,34,76,27,175
7244,67,42,54,47,210
3983,44,62,53,52,211
4125,67,45,46,60,218
4721,34,55,19,47,155
1077,48,48,59,64,219
1150,31,51,54,46,182
5519,57,41,63,66,227
6969,52,35,54,56,197
7482,73,55,38,44,210
2180,73,44,55,57,229
7880,46,52,64,46,208
3359,28,73,18,66,185
2908,49,63,34,24,170
8725,31,61,27,42,161
8180,70,77,71,31,249
4167,69,32,47,68,216
8098,56,65,58,4,183
4155,19,64,67,42,192
9855,55,45,63,76,239
6593,52,34,58,46,190
313,32,57,40,79,208
1129,46,46,66,58,216
1918,46,65,46,36,193
1276,44,42,31,35,152
7873,70,34,34,56,194
6838,45,62,40,44,191
6288,73,34,31,59,197
6007,75,30,52,55,212
4687,53,59,60,59,231
7716,43,56,63,66,228
4482,50,45,27,40,162
1194,68,63,70,71,272
243,72,41,61,65,239
7025,52,63,47,39,201
4830,45,39,64,50,198
6452,39,16,67,33,155
5370,43,40,49,78,210
6311,63,50,51,38,202
2853,33,46,50,32,161
5842,27,64,31,69,191
7119,47,38,31,88,204
5960,40,57,56,21,174
7823,39,43,43,68,193
508,70,49,18,37,174
2107,41,52,69,59,221
3183,72,40,34,37,183
6719,52,67,54,66,239
1674,60,22,51,49,182
1267,57,56,32,23,168
937,35,50,40,39,164
1893,52,65,50,51,218
5373,87,48,52,58,245
1595,55,38,39,62,194
5222,65,84,35,45,229
4400,39,54,66,30,189
913,65,57,33,37,192
2386,51,37,49,53,190
6737,59,62,27,62,210
2166,39,59,48,59,205
7761,34,74,23,63,194
7289,44,48,48,52,192
7587,38,48,40,70,196
5720,39,52,46,51,188
9972,48,45,57,37,187
9111,28,61,60,29,178
6443,50,34,66,61,211
1842,40,19,53,29,141
570,9,53,45,43,150
6017,43,39,59,32,173
1525,25,40,32,78,175
4384,62,20,57,43,182
1390,63,30,45,25,163
4515,55,45,68,17,185
1845,43,52,53,51,199
7213,38,34,31,35,138
64,43,72,61,83,259
1481,41,32,48,24,145
1398,87,80,39,47,253
574,84,57,54,20,215
9412,52,73,49,53,227
345,41,60,19,36,156
7090,61,53,53,43,210
9431,30,25,57,39,151
4164,57,52,45,46,200
4200,43,56,64,54,217
2462,59,41,37,48,185
9611,32,38,62,38,170
4901,78,60,36,65,239
7723,34,74,24,50,182
9854,73,82,46,34,235
9349,27,44,61,39,171
1625,29,66,48,37,180
7820,71,46,46,41,204
6460,34,71,94,62,261
9670,65,40,41,38,184
7589,47,56,65,61,229
1996,52,31,50,58,191
9040,22,43,75,50,190
1447,51,49,22,70,192
779,54,70,24,74,222
9511,87,39,59,52,237
8563,54,48,25,30,157
2367,42,52,44,41,179
827,59,36,39,43,177
344,61,64,77,44,246
2555,27,48,52,34,161
1746,29,27,46,41,143
8480,39,14,45,61,159
5958,68,39,30,40,177
9300,60,45,65,35,205
928,14,42,57,69,182
7694,36,57,45,37,175
187,69,80,32,41,222
58,33,43,35,62,173
4006,31,56,45,60,192
3385,66,62,67,50,245
2964,54,42,46,54,196
5284,43,44,47,67,201
6010,49,48,42,45,184
376,27,75,53,62,217
439,48,59,46,72,225
4370,67,41,48,46,202
4124,56,26,56,58,196
1082,51,83,38,39,211
5531,54,60,73,53,240
797,31,49,61,55,196
9605,59,41,56,46,202
3836,50,62,69,44,225
4947,35,80,64,68,247
3833,65,79,22,68,234
6112,27,50,47,7,131
1438,70,56,30,68,224
896,57,35,45,40,177
5117,43,50,47,34,174
6651,49,21,46,45,161
6227,62,49,62,53,226
1015,54,57,39,28,178
9326,66,47,43,47,203
1488,59,59,63,54,235
416,37,42,62,36,177
4382,46,48,52,37,183
862,55,33,55,54,197
3680,25,83,45,0,153
1513,40,70,40,58,208
1554,61,58,40,45,204
5011,42,52,56,67,217
5830,53,35,45,34,167
9403,46,34,51,49,180
8497,18,41,50,32,141
1337,55,58,26,65,204
9380,49,47,15,26,137
2946,63,75,36,48,222
5639,49,53,56,42,200
7423,28,61,41,35,165
9259,64,45,53,53,215
8834,46,36,25,57,164
8499,83,62,63,27,235
7567,54,63,68,64,249
7141,71,38,39,53,201
5471,67,40,66,68,241
556,49,53,19,46,167
689,37,63,42,28,170
3590,42,79,46,54,221
492,40,50,49,67,206
6613,69,51,46,54,220
2898,59,40,55,31,185
3870,66,31,47,51,195
2603,63,60,36,37,196
4736,33,49,24,30,136
8832,45,70,53,74,242
2365,52,57,56,21,186
2332,44,65,39,41,189
5897,69,50,34,37,190
7853,36,46,68,43,193
8698,41,69,26,74,210
9750,62,76,27,58,223
4332,51,66,33,64,214
3808,37,53,38,47,175
8031,45,45,37,50,177
4309,41,68,42,46,197
901,55,69,67,44,235
9165,56,48,52,60,216
237,58,63,36,65,222
1460,80,43,19,55,197
7419,47,67,33,55,202
6297,62,77,26,44,209
1877,53,54,51,34,192
2866,17,55,46,82,200
7081,48,36,54,53,191
363,36,53,40,43,172
4121,48,37,40,56,181
1432,31,47,72,38,188
7076,52,31,68,53,204
1794,63,28,69,44,204
124,65,46,21,50,182
7041,61,45,43,43,192
2722,65,62,58,61,246
9327,17,75,44,82,218
618,46,61,38,26,171
7048,57,59,56,52,224
7756,68,55,15,48,186
5572,42,50,78,38,208
8677,78,79,30,42,229
8683,54,54,57,42,207
1422,64,66,32,39,201
1862,62,54,24,53,193
2558,53,62,39,47,201
3567,50,36,35,45,166
3106,51,61,37,54,203
1201,29,42,62,41,174
3493,39,68,50,52,209
8703,20,41,33,38,132
659,57,64,49,37,207
1334,39,31,38,36,144
4970,58,55,22,62,197
4367,33,71,24,49,177
6713,69,89,57,49,264
5866,66,16,50,32,164
3328,74,27,56,49,206
8606,44,47,48,36,175
4785,63,39,38,37,177
5954,44,55,61,88,248
2952,37,49,27,29,142
5896,24,40,32,37,133
1937,58,46,33,50,187
6341,65,42,40,50,197
9962,9,60,46,24,139
6560,54,49,53,18,174
9986,48,55,4,71,178
1196,53,58,54,79,244
7507,39,56,61,32,188
4895,53,44,69,70,236
3062,45,51,44,56,196
3216,47,51,52,61,211
3761,28,43,31,87,189
1426,70,42,73,34,219
9629,55,22,55,45,177
7547,54,44,59,36,193
1979,49,23,37,64,173
4065,63,78,44,54,239
8299,79,64,51,34,228
5878,42,36,61,41,180
8482,33,84,31,41,189
162,66,58,51,77,252
8833,56,64,59,48,227
4120,73,47,68,50,238
6547,60,78,53,48,239
3066,41,58,67,54,220
5116,68,64,33,54,219
2479,38,58,61,58,215
4837,57,55,73,72,257
5095,43,62,54,42,201
9686,46,27,63,54,190
5935,46,41,44,60,191
7118,73,46,57,60,236
5241,59,55,66,41,221
5551,60,53,39,48,200
852,56,69,61,42,228
665,71,51,45,42,209
5304,49,18,51,55,173
6190,75,49,72,51,247
288,44,43,64,45,196
3077,37,50,56,55,198
1812,43,62,46,49,200
8458,48,46,41,46,181
2322,37,34,66,76,213
3801,30,51,85,56,222
2509,46,34,34,52,166
2230,52,32,66,48,198
4674,77,56,49,46,228
3838,69,49,36,46,200
2246,47,52,33,56,188
3709,40,28,59,70,197
4647,40,55,41,58,194
6147,93,63,41,50,247
9320,45,61,46,66,218
2794,73,32,70,25,200
4194,22,46,59,39,166
5111,73,63,42,27,205
8546,38,24,71,71,204
1694,45,18,61,39,163
9397,55,39,67,59,220
7561,52,91,69,33,245
2117,66,53,43,24,186
2586,53,59,33,47,192
2421,17,55,51,50,173
5374,13,45,48,43,149
5548,48,84,32,42,206
8751,44,48,58,62,212
7315,74,59,47,31,211
1566,44,68,39,78,229
5541,12,64,62,55,193
627,34,28,44,53,159
3164,66,59,71,61,257
4220,48,33,54,28,163
353,78,31,35,37,181
7953,41,65,17,54,177
8129,77,36,59,39,211
7641,45,48,73,74,240
925,29,54,60,63,206
3671,5,58,62,23,148
9702,41,46,42,44,173
8733,81,33,49,66,229
2474,79,62,75,69,285
2999,73,49,49,57,228
663,59,94,47,63,263
4476,51,53,21,21,146
6215,41,35,29,64,169
3477,63,45,45,59,212
1208,60,56,41,66,223
3028,52,85,57,40,234
6020,32,58,60,44,194
7402,40,57,43,55,195
6548,30,75,89,28,222
5631,47,31,57,46,181
5336,51,40,57,35,183
1778,78,40,69,74,261
9028,47,0,46,52,145
2346,52,80,52,70,254
4033,22,76,52,56,206
4102,60,6,95,57,218
5643,38,30,60,54,182
1543,49,61,33,60,203
2092,19,42,54,83,198
1142,64,57,65,14,200
7841,81,67,53,69,270
2414,32,35,16,73,156
7613,52,59,42,39,192
6866,40,33,60,45,178
2113,51,43,39,54,187
2704,41,37,57,41,176
6072,34,64,49,42,189
1264,69,40,44,26,179
3812,29,74,24,50,177
2034,27,16,46,39,128
5281,20,60,61,45,186
5287,52,31,22,36,141
1609,47,52,33,27,159
8631,36,45,36,40,157
8114,48,29,63,36,176
9103,47,58,45,36,186
4485,56,77,62,59,254
5472,41,61,50,45,197
9341,44,30,21,48,143
8506,44,52,56,41,193
511,30,31,58,63,182
4385,21,42,67,43,173
1297,51,57,27,55,190
7835,70,82,48,78,278
8382,60,56,45,66,227
5410,55,59,36,65,215
793,51,32,75,80,238
8709,64,65,72,76,277
8013,50,48,48,45,191
9944,61,61,30,33,185
2755,96,31,7,40,174
5889,52,31,52,28,163
7979,74,46,80,39,239
8217,63,37,30,33,163
3928,64,48,37,39,188
1936,57,41,75,41,214
7663,64,62,28,52,206
37,39,42,47,44,172
4184,29,42,59,58,188
397,60,44,61,53,218
7849,53,37,34,38,162
2836,52,43,65,33,193
5400,50,29,58,52,189
3958,55,77,40,42,214
4936,63,45,42,78,228
4742,74,50,52,49,225
8038,46,61,49,36,192
1965,45,49,41,90,225
335,36,38,44,66,184
7504,57,51,34,53,195
9517,68,59,32,41,200
2297,54,58,39,39,190
6554,60,76,43,40,219
4507,43,33,55,80,211
1709,48,61,26,69,204
2484,80,74,41,59,254
4448,46,35,34,62,177
8448,53,55,68,65,241
8604,52,21,30,27,130
6876,39,60,46,22,167
2466,53,41,38,77,209
8657,37,62,29,41,169
4779,25,50,44,31,150
287,39,48,64,29,180
626,59,50,33,78,220
6689,33,69,59,33,194
3104,38,52,61,54,205
8542,27,57,42,66,192
549,51,67,37,63,218
1725,49,46,45,30,170
6705,53,84,31,46,214
7079,61,38,35,46,180
3882,34,58,38,46,176
9353,40,29,62,64,195
4955,57,44,39,54,194
9644,98,52,60,54,264
1252,34,29,68,33,164
3738,42,46,74,49,211
6657,49,63,70,34,216
9575,21,69,23,61,174
6030,16,57,46,62,181
2308,42,31,66,40,179
9610,46,37,42,55,180
6914,34,40,41,54,169
1042,27,54,32,80,193
6726,59,84,50,43,236
8049,46,61,47,33,187
5270,43,90,36,44,213
1714,47,42,29,55,173
513,33,72,78,40,223
6174,37,7,79,47,170
1159,15,42,77,51,185
9434,34,45,54,23,156
630,44,27,22,71,164
7532,69,56,71,28,224
8182,61,23,56,51,191
8192,62,54,34,52,202
2291,55,64,13,69,201
1018,52,55,64,35,206
8706,71,48,30,29,178
4693,48,67,42,37,194
2472,55,63,42,59,219
179,46,59,19,24,148
4314,50,38,69,47,204
4853,71,80,48,34,233
9514,30,11,43,83,167
226,33,46,38,49,166
3455,51,46,51,36,184
982,41,56,52,35,184
4930,49,4,33,33,119
9113,79,39,86,14,218
6167,24,59,49,53,185
9487,31,30,31,34,126
5307,43,15,65,56,179
4205,43,41,42,42,168
9499,49,30,42,16,137
6424,41,43,24,56,164
4582,58,65,55,74,252
3330,81,61,77,38,257
8704,50,30,77,64,221
50,46,35,55,35,171
1868,48,49,25,65,187
772,64,52,78,43,237
2407,75,57,55,53,240
2742,39,52,58,73,222
949,38,30,61,50,179
1329,18,56,43,65,182
5943,40,58,100,43,241
9960,47,52,54,59,212
2796,23,55,68,64,210
1273,58,52,72,64,246
6086,40,54,45,64,203
3976,31,36,46,37,150
3705,32,84,44,49,209
6011,61,27,55,45,188
4746,51,41,41,28,161
5748,72,23,26,62,183
7146,65,22,34,57,178
9522,51,78,49,37,215
8315,42,39,48,50,179
3212,58,45,52,61,216
9624,40,34,64,43,181
1505,61,61,43,54,219
9737,63,50,40,23,176
5933,60,57,40,37,194
9226,42,50,57,52,201
1650,60,54,59,44,217
2643,38,37,68,48,191
5965,54,42,58,80,234
8055,72,69,55,36,232
8889,41,44,48,49,182
2082,53,56,54,41,204
1223,61,51,50,8,170
9539,26,46,51,38,161
6573,52,64,26,12,154
4784,43,17,70,50,180
3858,49,56,55,31,191
5283,31,80,64,59,234
2207,48,59,51,40,198
1844,75,16,37,66,194
4699,15,32,57,51,155
2000,52,49,33,42,176
6585,64,45,36,47,192
8774,41,34,52,25,152
1061,50,54,66,25,195
1325,23,28,52,24,127
9144,65,50,58,49,222
9905,59,46,50,53,208
420,48,39,46,35,168
9652,57,69,41,27,194
2378,42,27,44,63,176
9456,83,54,45,62,244
6263,43,50,72,36,201
765,59,54,19,64,196
7957,54,36,61,54,205
2852,56,51,71,43,221
7866,72,44,54,57,227
9502,38,61,50,61,210
5089,51,58,18,40,167
8685,66,42,63,42,213
5103,40,49,52,32,173
7981,43,70,46,44,203
7831,31,23,60,29,143
4343,47,44,62,35,188
4762,41,49,53,62,205
5906,60,63,42,57,222
6877,61,57,47,49,214
7903,28,66,32,42,168
9007,31,29,28,34,122
2981,70,47,50,53,220
2757,24,17,50,65,156
4298,32,86,32,51,201
589,50,34,46,42,172
9617,40,34,40,68,182
3275,44,39,31,30,144
2867,68,50,30,37,185
6111,47,55,55,28,185
7617,52,47,67,12,178
5231,40,61,46,46,193
7489,55,50,68,29,202
6136,63,60,62,57,242
1182,24,45,30,27,126
9673,44,32,63,30,169
7351,78,41,73,52,244
8042,54,36,26,61,177
5638,33,62,45,37,177
3714,52,27,69,41,189
5723,26,52,29,54,161
367,36,52,57,75,220
8334,79,37,34,76,226
3087,56,58,43,15,172
1239,66,66,40,81,253
6156,50,68,37,57,212
1414,31,44,62,57,194
8919,81,94,37,29,241
8108,50,63,60,40,213
7183,79,43,37,38,197
1474,48,56,29,69,202
669,59,27,72,70,228
5366,38,66,56,62,222
7377,47,24,25,49,145
4532,68,39,31,58,196
3810,61,27,49,48,185
6748,81,56,43,65,245
23,25,64,22,73,184
2068,47,48,46,52,193
9146,53,50,45,61,209
6003,35,40,55,61,191
1678,58,33,33,42,166
8498,55,35,62,70,222
9489,47,83,50,30,210
7304,46,52,54,40,192
2084,56,51,52,25,184
166,43,38,23,35,139
9310,65,49,62,11,187
3219,46,36,68,53,203
9151,30,67,46,23,166
1225,65,79,91,57,292
5034,58,50,69,45,222
755,72,45,53,46,216
6845,79,74,46,41,240
6082,35,50,51,52,188
8857,46,55,45,49,195
5355,41,64,61,63,229
178,40,43,63,32,178
874,39,66,71,52,228
967,26,58,56,47,187
4318,50,38,67,57,212
908,70,38,57,49,214
1798,35,39,43,36,153
2550,35,61,50,49,195
7195,61,45,43,73,222
4926,69,39,25,58,191
5549,60,68,63,41,232
9693,54,45,61,39,199
5671,72,38,55,37,202
5847,52,72,49,42,215
3915,40,51,37,56,184
5593,77,88,23,55,243
4661,65,64,71,69,269
7725,23,50,34,46,153
5623,75,29,37,32,173
8582,31,66,28,71,196
4420,29,44,24,51,148
4281,52,41,53,77,223
5926,60,75,85,70,290
7011,53,55,63,38,209
6546,53,58,36,74,221
8819,70,45,31,68,214
2500,46,59,48,68,221
81,51,62,56,59,228
5848,50,48,32,70,200
1658,61,41,64,46,212
1204,48,33,50,67,198
4259,36,22,71,35,164
2015,59,41,46,63,209
9222,47,56,39,58,200
323,45,55,35,57,192
1103,57,66,38,40,201
2345,48,56,59,30,193
4996,46,38,39,70,193
8697,41,36,45,64,186
5642,66,48,47,45,206
3559,57,49,46,47,199
4547,60,63,56,47,226
4132,45,40,86,69,240
1982,58,59,61,36,214
9549,38,49,19,35,141
7631,62,63,49,54,228
6622,50,23,68,56,197
8783,65,72,41,42,220
6660,20,76,54,36,186
3699,49,66,39,19,173
1841,21,63,61,53,198
8895,90,73,54,58,275
1074,47,87,40,35,209
3213,76,36,52,28,192
7629,37,21,53,43,154
8280,31,45,58,70,204
7699,35,51,61,52,199
882,75,53,57,66,251
1282,27,54,13,61,155
8799,56,25,59,40,180
3525,61,59,52,33,205
429,35,55,28,51,169
594,12,29,75,63,179
4391,30,32,15,43,120
9460,55,45,50,45,195
4672,47,48,33,64,192
9568,28,61,40,27,156
8091,74,75,58,40,247
1482,57,48,49,44,198
8817,37,73,56,51,217
1133,21,48,24,61,154
1240,62,70,67,25,224
263,50,66,52,55,223
6582,23,19,40,59,141
2837,49,13,59,37,158
9525,53,56,0,44,153
7401,49,27,29,48,153
8477,45,59,33,56,193
217,49,42,62,20,173
7763,69,44,44,64,221
8876,31,37,19,24,111
572,48,62,45,77,232
7190,49,78,47,92,266
1258,43,39,47,35,164
4091,74,51,25,54,204
2844,38,60,49,63,210
1705,58,37,74,55,224
2428,66,55,57,68,246
7249,55,57,63,21,196
6730,60,50,34,65,209
3821,36,37,74,34,181
6418,59,53,27,55,194
6397,53,43,65,74,235
3001,48,69,71,53,241
9508,48,31,46,25,150
7147,62,45,60,34,201
3021,63,46,50,47,206
7220,40,37,44,61,182
3088,43,37,41,50,171
9967,50,37,49,62,198
3448,36,47,38,60,181
6733,36,48,55,56,195
1416,38,25,33,67,163
8435,51,56,30,48,185
1582,44,55,45,68,212
1445,93,58,48,62,261
2563,41,46,27,29,143
9463,23,22,65,40,150
8490,76,26,45,66,213
6092,38,35,56,40,169
8816,56,62,47,42,207
4087,41,36,64,50,191
7818,65,35,18,50,168
1358,34,62,31,48,175
8999,67,80,66,62,275
622,33,50,49,37,169
9680,50,32,29,41,152
8381,44,39,57,79,219
4896,73,46,35,32,186
1177,74,56,75,46,251
9881,66,50,50,75,241
9776,56,47,55,62,220
9601,50,46,49,55,200
7462,66,31,58,49,204
4407,54,52,66,44,216
2840,62,27,37,39,165
3585,60,44,67,57,228
2186,38,38,100,38,214
2449,47,30,32,75,184
1602,49,34,56,46,185
3025,60,47,61,19,187
9379,46,54,49,48,197
2470,50,41,44,43,178
9093,52,92,22,86,252
2160,46,35,43,48,172
2976,49,64,41,43,197
9521,51,49,71,54,225
558,43,50,43,37,173
5478,47,29,51,78,205
6260,58,16,39,58,171
9404,35,42,29,52,158
6367,47,23,67,32,169
2887,58,27,60,33,178
7050,59,32,22,34,147
7546,49,43,38,34,164
2340,73,37,44,72,226
3654,21,23,48,40,132
5766,41,37,59,42,179
7192,34,41,16,39,130
5730,52,31,52,35,170
5294,53,31,28,43,155
7970,51,48,63,31,193
154,53,38,80,67,238
6188,38,36,65,43,182
91,94,39,41,83,257
7407,73,27,41,43,184
6170,38,58,72,24,192
1356,27,51,67,76,221
6309,78,34,34,33,179
9564,38,51,88,45,222
4595,39,45,59,39,182
6099,35,65,72,44,216
5455,58,44,60,63,225
1696,70,60,44,40,214
4330,53,50,56,45,204
1251,20,59,37,60,176
1508,34,61,38,53,186
2438,37,45,64,34,180
1909,75,12,56,25,168
3063,51,44,34,61,190
4805,52,51,87,39,229
3231,34,41,100,78,253
7883,52,34,65,56,207
7094,55,49,50,52,206
5813,10,80,67,59,216
2769,73,40,44,58,215
3978,56,43,60,32,191
2793,56,22,67,72,217
1955,63,51,45,58,217
9662,26,36,50,51,163
560,53,35,46,42,176
6402,29,53,57,60,199
140,30,52,41,44,167
2143,62,46,41,47,196
503,22,28,39,50,139
4030,74,35,60,38,207
5899,60,68,60,76,264
2190,65,29,48,60,202
7647,69,39,34,59,201
7360,41,29,62,58,190
5751,30,47,45,35,157
489,52,39,35,41,167
2074,89,69,43,53,254
6783,49,40,38,70,197
4439,66,49,28,40,183
3946,42,41,51,60,194
4579,59,70,43,80,252
8310,45,33,57,47,182
1515,55,70,61,54,240
3392,41,36,46,73,196
2236,39,22,65,75,201
7235,31,57,41,30,159
6359,36,41,58,35,170
6762,26,41,47,76,190
2849,42,47,57,59,205
4291,53,55,45,43,196
3412,53,61,75,77,266
1365,54,63,72,70,259
5104,76,67,58,55,256
8372,50,58,36,51,195
4734,60,35,15,73,183
5725,64,71,71,57,263
7889,43,61,42,45,191
9805,39,43,32,68,182
3764,45,48,42,51,186
5966,46,80,42,46,214
2210,56,32,26,43,157
1291,40,30,48,70,188
2708,27,73,60,22,182
1815,47,62,53,48,210
4714,24,50,20,75,169
8275,67,43,30,46,186
8133,79,39,47,47,212
7032,50,61,54,41,206
9630,21,44,57,58,180
8201,37,76,50,62,225
6437,67,87,34,42,230
5207,42,62,39,63,206
6405,67,38,22,47,174
4668,37,27,49,20,133
6893,64,21,53,60,198
7332,46,36,66,39,187
9385,33,26,36,45,140
3091,47,32,33,46,158
6633,45,37,66,69,217
4403,45,67,65,40,217
9270,72,48,53,68,241
4005,40,58,39,53,190
3703,38,41,26,70,175
890,52,30,56,70,208
4450,56,39,61,75,231
6518,53,24,41,59,177
4755,50,42,54,26,172
7702,67,78,42,58,245
3198,33,28,43,54,158
4411,54,41,21,30,146
679,35,35,54,37,161
4077,23,40,35,38,136
6674,68,65,63,48,244
3885,79,55,45,32,211
7734,55,64,30,44,193
9552,41,70,46,35,192
1286,18,56,40,72,186
1816,65,59,48,50,222
7854,60,65,26,46,197
9877,46,68,57,83,254
8696,39,48,66,56,209
4158,25,77,35,54,191
2132,42,83,60,68,253
6223,71,45,37,50,203
4609,35,41,29,63,168
2920,34,49,77,61,221
6034,53,40,52,40,185
7102,45,53,85,62,245
8059,58,37,56,70,221
5664,53,54,21,52,180
1374,76,65,74,12,227
5850,55,44,17,40,156
9925,55,69,34,38,196
8397,46,23,42,53,164
8653,53,15,46,54,168
1800,57,82,77,32,248
6836,52,64,68,57,241
6747,42,38,61,50,191
4405,62,63,49,45,219
9347,76,54,36,22,188
4119,37,18,42,59,156
5225,52,62,54,33,201
5854,48,40,55,35,178
9685,71,54,54,69,248
7149,40,79,68,55,242
4823,49,54,23,48,174
7366,36,50,43,36,165
1266,45,46,30,39,160
9515,36,58,71,60,225
6791,43,3,48,36,130
8195,43,36,67,48,194
8211,24,56,61,24,165
8297,19,44,47,45,155
9170,43,56,42,53,194
4028,55,31,25,72,183
1303,44,33,62,33,172
2936,71,58,52,78,259
9074,33,87,62,59,241
5997,48,27,54,60,189
3067,41,34,47,35,157
7187,73,40,37,27,177
9774,88,41,39,42,210
1069,30,78,33,30,171
4324,57,66,73,39,235
2702,53,53,77,57,240
7503,29,33,64,29,155
7966,50,40,16,66,172
3598,80,41,24,52,197
5431,62,52,37,54,205
4274,51,41,39,34,165
7705,66,43,35,55,199
9620,36,58,50,38,182
7974,63,44,59,36,202
7608,56,25,25,37,143
6864,86,61,12,31,190
5898,64,46,66,59,235
3522,40,75,36,40,191
2672,62,31,42,51,186
2192,28,90,50,26,194
1639,33,54,23,36,146
4446,38,37,81,43,199
7466,41,45,52,74,212
3873,34,44,53,22,153
216,41,39,52,46,178
1330,67,41,58,37,203
2784,56,56,19,35,166
8880,27,51,57,31,166
6971,42,43,39,38,162
77,73,67,30,68,238
4833,19,43,58,73,193
1131,58,56,23,56,193
1833,42,64,48,35,189
6324,65,63,23,50,201
1175,44,39,42,68,193
8303,48,58,62,25,193
2903,44,3,72,32,151
2004,66,47,64,47,224
9036,36,28,39,23,126
1983,70,59,28,56,213
778,46,38,63,72,219
1768,46,66,63,63,238
238,45,55,64,16,180
5430,56,67,25,28,176
6218,50,63,34,54,201
3252,32,28,44,11,115
4701,38,13,7,46,104
3004,60,44,65,83,252
9061,55,41,38,65,199
5122,63,60,67,79,269
786,40,49,48,48,185
30,29,42,58,54,183
8261,64,41,63,13,181
9996,36,63,39,48,186
3129,34,77,78,33,222
7453,76,25,44,45,190
4751,47,44,46,40,177
1183,82,23,22,60,187
4875,41,64,5,34,144
7781,29,44,25,14,112
4231,60,54,34,42,190
5358,67,32,10,29,138
5388,62,48,41,49,200
9461,85,59,62,37,243
5166,63,27,46,69,205
1763,74,42,61,44,221
8258,55,69,34,40,198
5450,27,48,70,71,216
3550,77,67,28,71,243
5381,22,69,71,37,199
8516,22,51,72,51,196
1085,67,42,88,41,238
9665,42,39,43,57,181
7073,61,49,52,25,187
3379,32,61,54,30,177
8884,54,57,87,43,241
2194,23,34,57,82,196
9600,45,56,43,46,190
61,44,54,40,48,186
4997,24,75,58,30,187
3973,49,30,63,34,176
3444,64,71,69,40,244
7175,49,61,22,52,184
2349,30,40,53,70,193
5170,72,58,51,49,230
6187,32,60,53,54,199
8144,43,55,17,48,163
9632,23,65,52,50,190
5930,48,59,32,72,211
9851,38,52,55,66,211
8579,50,42,38,36,166
138,61,48,64,50,223
5458,35,52,39,56,182
897,59,56,19,53,187
2388,44,47,25,62,178
6761,17,23,43,19,102
1856,34,62,45,40,181
3849,50,51,64,40,205
9073,22,75,59,58,214
1143,45,25,45,56,171
8611,25,50,57,76,208
968,32,36,49,62,179
7577,71,38,65,48,222
9661,51,55,65,55,226
1124,42,61,38,11,152
3853,51,36,53,23,163
534,57,66,74,41,238
9125,46,33,42,55,176
6779,59,37,61,49,206
8246,24,25,47,78,174
4925,47,78,35,42,202
2975,25,43,41,37,146
221,75,45,41,41,202
6195,43,54,59,48,204
2075,36,73,51,56,216
6278,62,54,59,77,252
1315,41,55,16,65,177
2138,77,53,40,37,207
9355,51,50,49,47,197
4914,20,65,74,62,221
3878,57,35,58,88,238
4786,33,40,60,25,158
2553,41,32,18,40,131
8713,51,42,62,50,205
5883,38,29,55,20,142
3192,24,26,19,25,94
8218,53,73,54,32,212
6488,59,30,24,44,157
2433,60,38,32,47,177
9374,23,36,20,16,95
6277,69,59,28,49,205
379,43,66,70,54,233
4843,58,34,52,63,207
6447,49,60,54,43,206
3691,64,84,47,29,224
6947,60,52,48,52,212
9339,33,51,75,56,215
5846,45,32,30,77,184
2031,41,65,55,53,214
7500,32,27,25,65,149
8078,39,40,62,59,200
4962,40,51,51,31,173
5532,55,100,69,60,284
8891,31,54,34,51,170
8350,54,44,33,55,186
2214,30,58,70,61,219
436,27,32,59,40,158
3072,39,46,42,53,180
9933,37,49,27,43,156
7066,40,22,56,51,169
5739,13,33,54,73,173
5086,62,43,37,73,215
6081,75,32,75,35,217
8634,59,40,32,50,181
2600,51,34,18,77,180
3319,48,57,52,63,220
3480,29,55,50,17,151
9957,52,44,70,72,238
7921,72,66,67,84,289
8655,30,60,30,12,132
8029,45,76,41,48,210
9595,54,64,54,24,196
6639,33,37,28,50,148
660,59,45,45,30,179
3127,50,68,37,69,224
815,41,82,81,50,254
2725,41,46,46,61,194
6894,61,55,61,52,229
457,55,43,52,53,203
6406,36,52,39,73,200
2749,63,26,47,53,189
3205,43,13,50,46,152
2832,53,64,42,41,200
4182,45,40,50,92,227
272,50,26,79,51,206
4240,55,17,66,43,181
2289,55,53,51,57,216
3820,38,46,45,65,194
6742,82,69,77,72,300
7925,63,42,71,48,224
8199,45,50,23,75,193
183,35,41,48,25,149
9586,30,75,36,56,197
4191,57,77,52,41,227
9131,46,58,76,54,234
1101,54,49,53,51,207
9496,44,55,66,23,188
8154,45,46,39,40,170
2231,45,49,57,41,192
6008,57,35,34,26,152
7218,27,12,43,68,150
7390,49,84,49,39,221
5615,28,33,38,35,134
3851,19,58,38,39,154
8543,65,54,41,44,204
9965,70,53,42,62,227
8765,49,49,54,70,222
1749,36,23,93,59,211
90,77,63,70,47,257
7450,65,35,39,37,176
6754,42,43,26,59,170
3490,39,63,57,35,194
551,61,29,54,55,199
7393,46,32,36,47,161
2147,56,31,71,48,206
4105,40,8,57,65,170
1917,81,65,6,45,197
3960,51,37,83,38,209
7432,66,53,32,44,195
9849,58,18,38,24,138
4633,34,38,24,12,108
9181,55,44,56,46,201
7905,42,72,52,67,233
2121,36,49,55,40,180
2622,59,24,23,43,149
2081,66,58,29,53,206
6459,44,61,55,54,214
409,41,20,35,48,144
2706,33,40,42,31,146
8313,63,71,47,71,252
1361,55,23,28,69,175
293,60,19,49,50,178
6950,13,35,51,38,137
2454,44,49,36,48,177
8845,42,37,46,32,157
258,100,23,75,53,251
8610,85,54,91,70,300
256,58,46,48,43,195
3108,71,65,69,45,250
6611,25,31,61,69,186
3044,52,41,49,67,209
942,58,31,37,40,166
8814,72,52,53,29,206
9003,43,36,57,18,154
9477,45,49,63,60,217
239,75,56,43,25,199
5684,69,58,67,48,242
5675,43,54,26,57,180
1825,45,0,60,50,155
1959,57,48,62,74,241
4684,55,52,36,60,203
2051,40,56,65,56,217
4299,45,49,53,48,195
9137,62,39,38,52,191
4264,56,27,44,65,192
2497,58,71,36,60,225
3780,66,16,68,65,215
9163,44,47,12,10,113
8279,49,69,66,88,272
8426,52,64,50,37,203
1659,35,59,42,45,181
5598,73,43,50,48,214
4539,76,36,59,54,225
7145,50,36,24,47,157
9382,36,60,62,36,194
8770,34,31,38,73,176
9126,46,33,0,29,108
2699,73,90,41,50,254
189,75,49,58,57,239
6816,54,67,67,51,239
3744,15,45,51,57,168
582,82,28,41,100,251
1562,54,40,40,57,191
9912,49,51,66,47,213
191,24,64,55,51,194
3624,59,67,56,61,243
6868,65,27,56,59,207
7267,61,40,59,42,202
7752,49,56,74,41,220
9070,54,57,68,60,239
4143,44,43,34,35,156
4802,59,27,42,57,185
8429,44,57,59,62,222
5106,76,48,27,37,188
88,63,41,9,67,180
7252,55,50,63,33,201
5592,59,64,23,42,188
823,58,64,82,56,260
2038,44,49,62,55,210
6684,65,19,36,43,163
6219,82,44,54,47,227
9266,42,47,55,31,175
9105,30,31,75,41,177
311,68,64,61,42,235
1243,40,65,55,65,225
2240,45,58,75,30,208
8810,61,14,59,29,163
7698,28,35,41,47,151
4,46,55,60,45,206
8718,32,48,22,47,149
613,28,37,72,27,164
6110,44,66,46,55,211
1500,49,48,41,70,208
4095,67,55,62,66,250
6928,30,60,67,66,223
7870,70,45,40,61,216
3206,33,64,70,39,206
1947,57,38,59,26,180
6592,18,45,48,44,155
3302,41,33,42,72,188
3656,40,65,37,27,169
685,85,37,60,37,219
6827,83,60,47,58,248
6678,78,20,52,39,189
7995,45,60,60,56,221
6122,53,32,68,42,195
3791,50,59,50,54,213
6390,39,61,2,35,137
2313,37,36,63,76,212
7028,84,64,22,54,224
7844,59,49,37,21,166
8405,53,46,60,54,213
8923,62,37,69,75,243
1692,52,43,43,24,162
3824,61,64,12,38,175
4800,46,27,46,41,160
794,64,81,29,35,209
9544,15,28,57,43,143
382,59,58,60,47,224
4453,17,27,61,60,165
1528,35,36,30,50,151
92,55,34,72,63,224
1203,38,73,30,39,180
4911,59,38,62,50,209
3538,36,68,69,51,224
5705,58,5,66,45,174
1003,56,41,36,67,200
9974,80,53,47,33,213
734,75,27,43,60,205
3117,42,67,60,34,203
5763,59,37,74,47,217
9485,32,69,21,49,171
8742,48,57,54,57,216
4170,47,38,63,49,197
7200,50,41,47,22,160
1517,50,71,36,34,191
6701,46,54,39,33,172
2930,57,34,57,75,223
4859,28,36,73,62,199
4348,35,33,66,66,200
2229,44,61,30,40,175
1603,60,50,48,55,213
9753,61,43,29,56,189
6019,60,25,45,58,188
8904,50,34,63,51,198
9312,59,37,46,38,180
9778,39,49,43,70,201
3634,59,68,52,44,223
9889,60,43,32,28,163
1385,37,82,67,60,246
454,22,77,84,19,202
5024,19,80,50,26,175
588,48,71,46,35,200
6273,46,44,42,49,181
3089,56,50,60,54,220
531,59,46,54,28,187
4491,46,36,33,47,162
1355,50,68,52,86,256
938,79,13,60,48,200
4756,36,58,40,64,198
6329,40,59,31,57,187
9233,56,33,20,40,149
5829,43,48,61,21,173
3555,41,52,54,44,191
9220,46,17,44,45,152
8132,45,61,13,25,144
7234,69,62,40,61,232
3343,35,78,34,12,159
3305,53,12,66,46,177
3449,51,43,57,62,213
9689,85,56,80,47,268
9321,18,79,31,51,179
5265,58,23,82,57,220
532,45,70,38,55,208
8112,36,56,67,56,215
7875,73,41,58,19,191
7697,27,74,65,52,218
9433,59,62,87,54,262
4128,59,49,57,57,222
4328,35,7,56,48,146
2782,61,44,19,39,163
10,40,70,76,62,248
1618,35,61,37,34,167
1467,32,58,64,44,198
9664,22,50,38,51,161
8827,17,38,60,71,186
757,39,78,44,36,197
4775,65,49,63,70,247
2816,76,13,40,38,167
5081,47,73,48,52,220
4487,53,39,31,55,178
1766,42,59,44,25,170
2547,60,57,66,79,262
5919,48,50,77,56,231
4928,52,54,54,76,236
4237,39,69,64,36,208
6448,34,55,46,55,190
1850,52,12,19,64,147
1139,58,40,46,55,199
6616,28,46,81,41,196
8190,72,55,39,60,226
6619,67,68,48,47,230
163,57,55,68,59,239
6233,32,32,45,51,160
5630,30,44,48,42,164
2965,54,24,59,53,190
7846,45,49,19,50,163
4416,47,32,49,30,158
9768,60,36,75,53,224
7495,23,69,57,62,211
5468,28,58,93,73,252
5901,42,37,73,83,235
4920,63,47,48,63,221
2204,73,32,61,49,215
5346,68,76,52,82,278
3383,83,64,43,51,241
2396,75,68,79,62,284
7623,32,44,54,28,158
4923,38,58,40,43,179
8873,25,40,59,33,157
303,32,52,56,37,177
3035,50,54,36,51,191
2511,19,76,42,35,172
4057,53,74,39,51,217
7240,34,68,59,54,215
4414,26,48,65,45,184
957,66,52,43,29,190
8869,22,65,46,27,160
6852,39,47,31,39,156
4238,60,31,40,42,173
5470,66,57,41,57,221
497,42,64,9,42,157
6385,46,38,60,39,183
3102,30,49,59,41,179
8389,36,55,64,78,233
6412,43,29,50,45,167
4021,80,49,53,49,231
788,30,25,65,74,194
5126,47,55,61,47,210
8695,57,55,42,53,207
1875,8,61,75,41,185
2632,32,65,55,51,203
161,31,27,43,51,152
7216,99,58,40,39,236
8075,55,50,51,47,203
8478,52,60,22,59,193
7395,45,66,65,37,213
4357,66,20,59,52,197
7158,32,45,49,71,197
2323,30,61,39,22,152
3726,45,49,35,30,159
2865,52,50,35,63,200
7396,48,53,37,48,186
7403,53,43,59,37,192
6421,61,73,82,50,266
9518,51,34,51,30,166
1561,52,66,24,43,185
1912,55,36,41,37,169
8505,63,46,99,37,245
4335,70,58,38,16,182
8670,74,35,37,62,208
240,53,67,60,87,267
3430,65,51,56,55,227
2427,26,82,44,33,185
1886,61,31,46,85,223
8222,45,41,62,53,201
3214,65,56,31,43,195
9121,35,35,61,45,176
9921,62,47,34,49,192
6061,62,23,38,57,180
2531,0,49,60,24,133
8766,39,77,27,53,196
3040,28,31,46,47,152
2781,46,36,70,52,204
1427,56,45,46,64,211
7255,54,54,49,53,210
4082,39,52,59,40,190
6425,68,40,44,26,178
387,64,65,49,24,202
6472,58,32,22,61,173
6814,46,62,66,63,237
2549,76,50,56,39,221
6383,21,38,51,58,168
9735,70,68,44,59,241
1154,21,66,65,59,211
6302,60,56,67,53,236
5481,76,47,66,52,241
4546,44,75,51,47,217
706,100,55,46,62,263
5937,34,39,46,51,170
4488,53,42,26,32,153
3937,71,44,32,25,172
4989,69,62,43,53,227
6224,41,31,21,67,160
7836,61,42,33,55,191
5172,38,51,49,62,200
3181,15,40,62,29,146
7099,64,70,73,30,237
1462,42,41,72,44,199
2739,31,51,67,63,212
131,63,57,78,42,240
8852,81,22,41,80,224
3224,29,27,25,75,156
7293,44,35,38,25,142
9383,3,55,63,61,182
3751,68,69,33,28,198
7926,23,54,34,62,173
336,48,52,65,32,197
2157,50,37,51,37,175
1958,33,41,28,58,160
4657,69,76,64,61,270
2876,57,32,8,48,145
4015,63,43,47,40,193
5616,35,63,64,31,193
5565,55,30,60,76,221
171,44,38,12,66,160
7226,33,61,72,51,217
7780,62,48,51,40,201
9302,23,51,88,43,205
2519,57,47,40,53,197
4979,51,62,52,58,223
741,69,62,36,35,202
717,55,65,56,56,232
8592,70,41,36,48,195
5032,10,69,52,71,202
7985,43,51,59,81,234
1469,69,27,55,37,188
3027,48,49,31,62,190
9970,36,50,35,55,176
6253,72,41,64,47,224
9745,7,44,45,49,145
1963,50,41,15,52,158
7170,68,73,47,66,254
177,41,47,61,69,218
4456,38,38,46,37,159
2035,62,49,54,50,215
8902,56,50,30,64,200
8830,6,64,46,24,140
8447,57,59,70,50,236
680,87,41,51,18,197
4481,50,37,22,54,163
4639,51,42,34,35,162
1343,41,38,35,72,186
7355,34,69,27,34,164
6826,68,29,47,16,160
9829,38,52,68,33,191
677,61,48,50,46,205
5955,37,61,64,80,242
7444,65,51,44,72,232
9742,57,51,58,48,214
5709,34,76,38,40,188
2529,53,51,60,35,199
1503,49,66,20,40,175
2645,60,35,39,55,189
6956,68,41,51,20,180
9420,61,78,58,43,240
6165,24,56,48,50,178
6797,31,54,66,52,203
5636,50,52,14,46,162
725,43,32,47,73,195
3469,60,77,62,36,235
425,48,48,72,56,224
9559,31,43,53,19,146
7791,60,46,37,43,186
8812,48,64,48,52,212
1413,58,49,68,36,211
4995,26,50,40,71,187
8025,41,57,56,6,160
8206,40,58,61,36,195
2721,66,46,75,52,239
4489,55,49,51,45,200
7022,35,29,67,68,199
3052,53,33,49,15,150
5092,28,39,44,41,152
6627,75,46,32,36,189
9817,30,78,29,80,217
760,62,47,64,37,210
2241,15,38,30,71,154
2858,80,54,31,45,210
731,35,78,53,31,197
4839,70,45,50,45,210
7759,35,40,67,29,171
7498,49,65,40,65,219
1153,53,49,33,50,185
1135,43,83,39,76,241
2647,38,47,39,59,183
4041,36,58,30,54,178
3083,60,52,73,57,242
1284,62,61,42,48,213
7609,8,58,57,40,163
5326,77,21,63,64,225
6918,55,57,77,40,229
1928,33,49,81,44,207
7838,80,54,59,44,237
9453,50,25,58,43,176
8862,55,43,49,32,179
4064,64,70,54,40,228
4293,43,66,29,67,205
364,67,28,73,58,226
1923,18,67,23,50,158
6245,41,58,67,41,207
5269,58,25,53,27,163
6363,53,61,26,34,174
6631,38,71,46,47,202
3137,65,66,41,15,187
5062,64,51,53,0,168
6495,52,53,69,39,213
6667,20,53,41,57,171
1615,44,22,41,30,137
5978,43,24,85,50,202
1703,27,61,74,22,184
4052,53,32,24,45,154
7586,58,23,61,60,202
2441,19,66,42,93,220
2792,46,62,60,42,210
1477,49,32,33,35,149
4619,74,34,56,55,219
5073,68,41,54,56,219
7000,52,50,80,44,226
1968,69,64,55,22,210
5826,65,51,57,48,221
9852,68,37,68,60,233
2766,21,79,35,58,193
8564,39,35,63,54,191
8674,46,27,51,42,166
5980,39,47,74,34,194
712,45,64,78,77,264
8414,68,59,41,46,214
8629,92,17,62,47,218
6183,53,81,64,57,255
9457,54,72,53,50,229
8273,54,45,57,42,198
7899,46,34,46,60,186
6934,28,36,31,33,128
7950,84,76,31,68,259
9765,56,55,34,36,181
9459,49,68,27,57,201
9919,52,40,73,48,213
934,36,42,31,75,184
1370,65,39,50,34,188
6811,17,39,52,43,151
4040,65,59,59,13,196
2263,51,29,55,70,205
400,26,71,50,69,216
9294,47,89,49,68,253
6995,24,24,39,58,145
1184,29,61,44,41,175
5688,36,22,41,54,153
3965,60,35,62,85,242
1541,32,49,74,18,173
1733,17,52,7,55,131
7540,48,26,39,42,155
3628,39,77,46,48,210
8148,64,43,15,28,150
5585,66,69,48,47,230
5875,54,34,18,30,136
4154,67,49,41,41,198
584,67,48,50,29,194
4203,77,34,62,46,219
3320,46,31,45,29,151
8155,56,41,63,58,218
1942,67,75,45,32,219
7930,55,54,45,42,196
393,12,54,11,50,127
9492,32,55,63,32,182
649,79,79,46,64,268
4334,49,58,53,38,198
8001,53,69,65,48,235
7327,70,51,69,47,237
8406,58,50,46,50,204
6475,70,44,93,36,243
6659,79,21,58,35,193
7461,31,47,41,35,154
2070,35,16,37,65,153
3843,44,50,28,46,168
5201,43,31,27,62,163
8553,73,51,47,68,239
7430,63,39,58,34,194
6776,34,61,44,44,183
9240,45,38,52,71,206
886,40,66,57,35,198
5775,31,50,39,32,152
9687,56,55,48,48,207
1972,69,39,59,48,215
7219,52,23,41,45,161
7348,64,55,48,48,215
8949,33,68,47,56,204
4612,51,42,47,39,179
9045,61,20,24,49,154
3974,46,64,33,19,162
530,48,49,51,65,213
6905,40,37,47,65,189
7062,39,32,25,44,140
880,52,63,47,37,199
5804,38,73,13,44,168
6579,61,59,67,57,244
653,72,52,46,51,221
6376,67,62,43,51,223
4271,56,28,20,57,161
2770,50,42,51,43,186
5322,66,53,56,39,214
4079,12,54,46,58,170
7915,30,71,34,59,194
361,48,36,72,51,207
9931,30,46,53,66,195
5507,44,43,60,24,171
2019,69,32,68,63,232
2577,45,54,49,51,199
958,46,53,60,41,200
9585,63,55,43,14,175
758,51,64,42,54,211
2059,83,25,46,54,208
9571,73,70,18,75,236
9101,53,49,68,73,243
5975,79,29,37,66,211
5951,31,49,59,48,187
6511,61,48,48,70,227
6720,56,23,44,40,163
5386,38,16,50,43,147
3642,63,58,76,52,249
2904,40,49,55,68,212
8161,66,60,11,66,203
9295,43,43,28,78,192
6083,57,62,38,47,204
9025,37,47,37,54,175
2461,57,49,49,80,235
2641,40,58,57,38,193
2355,50,52,53,56,211
3142,35,45,58,23,161
7016,39,27,56,70,192
966,26,36,70,57,189
9814,50,56,42,70,218
8941,62,36,58,87,243
9288,25,64,37,33,159
2551,49,55,69,38,211
251,26,59,35,52,172
2036,54,42,25,74,195
8890,47,56,40,40,183
5932,100,43,32,59,234
1415,16,54,39,53,162
985,17,45,55,42,159
9204,40,18,81,65,204
6545,41,48,49,62,200
8333,44,68,44,60,216
3711,30,52,48,57,187
7693,68,66,42,66,242
1228,45,28,66,38,177
6479,47,60,12,61,180
467,28,79,30,58,195
2520,22,79,80,63,244
2159,59,53,58,53,223
5743,32,42,78,44,196
276,36,57,25,53,171
6436,37,82,54,61,234
496,58,20,59,17,154
9147,46,45,52,63,206
1179,45,62,21,61,189
8791,52,77,53,69,251
1612,99,65,37,33,234
7559,60,41,76,66,243
2226,58,34,29,35,156
1687,40,45,49,49,183
1106,51,70,53,34,208
1147,31,57,54,62,204
6736,54,69,53,70,246
355,40,45,50,56,191
7335,26,62,63,46,197
1786,23,47,58,42,170
4261,29,64,36,51,180
9580,47,26,65,14,152
1677,58,46,43,49,196
2857,19,41,54,28,142
6717,37,50,56,40,183
4166,47,31,35,50,163
6121,26,49,67,70,212
9530,54,43,77,89,263
9668,46,49,28,49,172
7036,25,49,36,44,154
3943,47,40,48,46,181
1693,25,51,50,32,158
9648,24,35,52,37,148
2398,42,50,63,48,203
5248,52,51,47,33,183
1366,68,56,35,33,192
9640,70,61,20,49,200
7424,46,57,47,36,186
7283,85,42,68,66,261
5570,55,43,40,42,180
2442,43,64,45,41,193
7801,54,18,70,63,205
844,37,62,63,54,216
6337,67,76,68,51,262
5298,61,56,48,35,200
2228,70,74,60,59,263
5150,34,26,42,38,140
7563,58,51,39,65,213
3802,28,26,29,63,146
66,66,78,28,49,221
5321,63,27,40,49,179
8982,48,54,35,60,197
8331,50,37,39,72,198
8076,32,35,60,61,188
6739,65,51,51,12,179
9365,50,67,52,50,219
7524,69,31,31,40,171
8727,56,72,68,47,243
1736,15,42,51,65,173
6758,57,48,37,50,192
5721,54,41,63,55,213
4827,30,41,76,12,159
5853,39,72,66,35,212
4590,44,40,42,70,196
5206,55,71,64,57,247
1079,53,62,48,36,199
297,23,37,96,44,200
8005,39,53,49,63,204
4892,60,61,58,57,236
7778,38,54,45,78,215
6109,55,64,24,48,191
6702,33,54,17,46,150
9301,66,75,73,50,264
8576,30,56,67,24,177
1224,37,73,100,45,255
8908,40,67,19,57,183
9982,30,60,54,46,190
9311,35,60,62,62,219
8723,55,39,48,51,193
5171,39,55,70,32,196
9802,60,55,42,35,192
5371,40,67,43,54,204
8618,58,61,42,45,206
8016,64,45,63,47,219
5680,77,33,24,68,202
2802,36,61,31,65,193
4049,14,71,69,57,211
7857,54,64,48,56,222
2818,65,46,42,52,205
9289,59,29,49,54,191
4622,49,75,59,39,222
2343,71,29,36,48,184
7375,36,66,47,53,202
3548,25,60,44,55,184
6558,53,68,56,45,222
4344,69,61,50,4,184
8137,60,21,22,12,115
9937,53,52,26,53,184
7523,67,43,42,81,233
8225,64,51,74,52,241
9868,28,79,54,69,230
8118,59,53,87,57,256
5153,46,76,61,26,209
9044,60,37,30,25,152
6765,49,41,53,5,148
8165,28,31,36,46,141
2808,40,55,57,27,179
1622,56,74,68,23,221
7483,62,52,71,21,206
2383,63,58,32,33,186
8548,33,44,59,56,192
1888,70,31,38,68,207
6847,39,72,65,37,213
360,52,58,37,47,194
4114,78,47,57,68,250
8666,52,48,81,69,250
893,53,47,79,50,229
4865,48,15,60,45,168
7110,56,48,26,64,194
8866,60,38,58,41,197
4042,55,12,28,32,127
2960,22,41,35,65,163
3826,37,73,68,53,231
9993,31,50,49,49,179
4098,28,48,69,24,169
8460,32,87,82,46,247
3689,51,48,66,45,210
6314,33,61,45,45,184
4055,68,72,34,33,207
3560,60,42,45,63,210
4820,64,37,43,66,210
433,89,71,43,40,243
1036,26,59,50,39,174
8795,55,47,51,35,188
858,61,33,20,47,161
7295,53,48,37,24,162
666,44,30,48,63,185
2988,39,61,64,59,223
7792,48,62,35,48,193
6347,42,62,45,44,193
1206,36,24,60,53,173
1115,29,57,33,27,146
5851,70,44,25,61,200
5420,80,55,36,59,230
9186,37,7,47,42,133
3340,63,83,46,37,229
8457,44,51,43,49,187
9292,52,48,74,46,220
7286,75,19,29,49,172
6654,69,32,39,43,183
9766,56,37,68,40,201
3894,52,29,52,59,192
5571,67,25,64,61,217
3460,81,95,46,51,273
6943,44,47,67,64,222
969,67,39,68,58,232
8169,47,64,66,79,256
2300,77,26,50,50,203
9169,44,38,36,30,148
7719,71,13,36,47,167
4397,58,57,66,50,231
2281,74,74,70,60,278
6173,51,51,50,40,192
4549,58,70,46,33,207
8527,51,64,24,27,166
919,51,55,39,62,207
2310,66,63,14,44,187
8933,61,50,91,52,254
7392,53,53,54,60,220
1565,70,36,25,32,163
3688,24,47,68,42,181
7031,34,42,45,32,153
4150,70,50,66,21,207
2029,47,29,48,47,171
4374,48,28,37,42,155
8288,55,48,66,59,228
5309,25,44,54,52,175
856,24,65,50,69,208
7143,35,65,37,38,175
9017,51,28,54,64,197
1624,46,57,50,55,208
3472,57,61,58,46,222
8858,49,40,42,60,191
7340,44,33,58,54,189
1521,72,82,29,40,223
3201,63,39,44,30,176
9318,33,44,48,49,174
1319,24,60,29,67,180
1559,51,49,53,46,199
3315,65,51,62,76,254
5852,25,37,84,25,171
5050,61,54,5,47,167
749,73,62,46,73,254
740,35,64,26,80,205
2639,53,19,50,77,199
2927,64,87,56,49,256
7071,46,51,64,45,206
7137,67,63,39,24,193
4228,29,20,44,77,170
9739,24,20,47,31,122
6744,60,52,35,19,166
4418,67,38,32,35,172
6569,67,44,55,55,221
6357,34,51,39,34,158
1073,72,64,42,30,208
8070,71,67,48,72,258
8462,50,60,55,32,197
5810,26,32,51,46,155
4097,38,75,38,28,179
2319,30,37,43,52,162
6119,74,15,41,41,171
1136,61,44,48,40,193
9284,43,30,52,48,173
1132,56,60,42,25,183
1420,37,57,51,33,178
4658,75,29,34,70,208
8051,34,58,25,38,155
8422,43,52,59,54,208
7632,49,89,40,37,215
5084,46,32,49,52,179
5453,39,36,37,45,157
3793,36,56,46,36,174
9780,45,56,27,45,173
8837,44,51,75,73,243
9759,71,80,62,62,275
1520,24,57,74,24,179
3304,60,59,61,41,221
2411,53,35,46,50,184
9396,79,33,34,31,177
3078,36,59,39,66,200
7987,50,22,39,43,154
8597,41,47,71,67,226
8255,49,32,42,50,173
5521,29,45,22,69,165
3860,53,47,39,53,192
7741,66,45,39,43,193
6410,42,58,51,46,197
3856,45,41,37,56,179
8986,60,67,51,50,228
678,50,44,49,45,188
2703,46,60,47,59,212
6032,39,63,39,35,176
7753,65,76,41,38,220
6057,27,38,51,44,160
1977,87,65,71,32,255
1685,60,49,34,62,205
8913,60,76,45,0,181
2924,72,40,76,80,268
9224,51,28,64,69,212
6815,51,73,36,8,168
2626,51,52,45,38,186
6509,40,39,23,63,165
3043,58,57,54,53,222
5049,62,23,65,51,201
581,46,68,61,74,249
6335,64,67,69,41,241
5115,26,23,61,44,154
9537,58,73,53,73,257
4551,64,26,48,57,195
7292,42,35,40,45,162
5098,42,55,84,54,235
8449,69,33,64,21,187
7314,57,44,18,37,156
8438,20,38,49,64,171
6039,42,65,37,41,185
4724,36,32,12,44,124
6992,52,66,58,19,195
3459,27,34,43,18,122
2238,48,59,58,71,236
200,49,57,63,58,227
1113,14,64,19,69,166
2406,12,54,57,83,206
1080,57,100,47,32,236
8714,52,43,38,63,196
3913,28,47,52,43,170
1902,43,68,66,57,234
2073,67,30,53,60,210
21,47,64,38,49,198
8471,49,56,62,52,219
5093,78,88,46,64,276
3386,34,46,67,50,197
9890,57,38,60,42,197
6940,25,43,51,32,151
4616,60,27,41,47,175
555,30,53,64,53,200
9053,65,61,45,21,192
9417,79,42,44,46,211
2546,39,54,32,45,170
1627,50,36,41,53,180
5000,58,59,66,52,235
3111,49,36,53,54,192
586,72,60,44,18,194
2052,30,38,57,53,178
7687,83,55,44,55,237
5859,85,23,49,59,216
38,40,37,51,36,164
5054,53,57,21,46,177
5779,76,67,20,16,179
7125,44,46,25,53,168
2202,29,51,46,68,194
424,49,36,47,43,175
1280,51,50,40,63,204
1691,40,17,36,70,163
7057,51,50,42,44,187
2587,69,32,60,46,207
6625,50,59,36,58,203
8525,71,36,68,52,227
5807,68,42,61,48,219
2824,0,52,43,52,147
6526,55,68,56,52,231
8724,56,44,74,73,247
554,36,48,43,63,190
4139,32,60,51,50,193
7722,35,57,81,83,256
6830,56,49,66,56,227
423,30,40,33,55,158
6642,35,21,51,43,150
1089,38,71,61,47,217
8934,65,48,54,38,205
261,54,51,26,47,178
7695,41,62,36,36,175
201,61,74,41,70,246
157,64,70,43,63,240
2910,17,52,48,36,153
322,67,47,56,60,230
5614,29,62,33,49,173
2762,49,54,43,39,185
1311,24,53,25,44,146
9361,42,46,44,61,193
7689,28,73,41,33,175
4710,76,67,52,50,245
4039,35,41,41,50,167
9304,80,36,49,57,222
8020,38,47,45,56,186
2877,70,42,67,51,230
1146,26,59,61,60,206
2501,66,38,49,64,217
5394,49,47,51,69,216
8600,72,63,43,71,249
5774,68,36,45,63,212
9293,65,70,45,39,219
3349,100,67,46,36,249
6469,38,74,19,71,202
9378,69,68,66,52,255
7120,33,64,53,30,180
2001,76,68,40,34,218
5016,72,57,34,58,221
9593,84,59,45,64,252
1371,60,56,46,11,173
3233,52,64,19,60,195
1268,59,56,37,42,194
5716,47,45,14,67,173
9560,77,32,78,58,245
9217,31,37,44,43,155
6916,47,30,61,45,183
6681,41,54,48,45,188
8213,32,47,30,66,175
3388,42,69,47,56,214
5075,50,56,48,43,197
9020,38,34,47,63,182
8149,79,35,55,75,244
8296,66,30,62,53,211
4043,59,43,20,72,194
321,50,53,49,50,202
4715,57,33,48,79,217
7969,59,64,56,51,230
4589,59,42,49,46,196
9533,45,56,51,64,216
4069,45,62,50,46,203
814,57,46,36,27,166
8343,37,51,52,54,194
3631,30,66,58,28,182
443,30,57,49,57,193
4232,51,37,54,69,211
3579,47,41,41,41,170
6294,42,60,84,53,239
218,51,71,57,41,220
8363,23,65,38,41,167
2022,66,65,27,36,194
9155,34,69,75,38,216
3961,47,17,60,42,166
5407,35,44,35,43,157
4387,43,62,62,45,212
5419,61,58,32,26,177
5145,56,29,64,54,203
8855,24,56,33,62,175
7026,38,26,37,70,171
6155,58,66,60,28,212
8785,59,43,26,24,152
6512,31,51,57,71,210
3519,34,71,35,54,194
9480,27,33,50,38,148
8483,51,28,36,42,157
2819,31,57,50,52,190
8518,21,73,54,58,206
5767,55,29,53,34,171
5445,44,59,53,39,195
6930,21,41,38,53,153
5986,80,31,15,28,154
4032,41,25,71,51,188
9532,54,45,49,50,198
2011,34,46,36,36,152
5221,82,46,78,63,269
175,46,59,51,52,208
1056,46,55,51,55,207
8842,41,31,42,34,148
515,61,73,50,44,228
5828,70,83,27,80,260
1099,45,72,69,67,253
3253,47,55,51,57,210
1652,22,80,41,39,182
1728,63,60,25,44,192
8646,67,56,76,65,264
6999,56,86,44,26,212
6938,85,37,57,53,232
8324,28,41,56,61,186
7505,60,49,41,53,203
2045,40,62,39,59,200
6340,76,54,81,68,279
9788,68,17,73,64,222
9141,64,32,58,52,206
180,36,43,55,55,189
9744,76,74,26,62,238
2874,62,39,33,51,185
9009,40,47,52,16,155
1607,52,71,47,65,235
8037,50,50,55,12,167
9791,39,58,47,47,191
2863,59,53,35,33,180
6818,43,38,50,59,190
309,21,48,58,41,168
2261,52,68,0,42,162
9263,49,35,60,82,226
3281,30,48,15,64,157
8064,38,47,40,33,158
3146,34,36,27,57,154
8408,53,55,55,68,231
1727,33,33,64,56,186
5233,50,23,57,28,158
9010,42,43,40,36,161
5840,39,78,64,48,229
3905,50,15,40,79,184
3790,61,53,41,59,214
6937,33,83,27,23,166
2050,54,55,38,38,185
2627,12,48,26,75,161
4244,70,49,23,49,191
7369,72,55,47,62,236
7168,26,55,71,42,194
846,71,43,47,37,198
9337,41,65,36,51,193
9440,63,31,64,72,230
5179,28,94,24,47,193
8991,30,46,50,27,153
7474,39,49,46,54,188
7803,81,59,62,17,219
8359,28,29,77,27,161
196,71,53,44,34,202
6649,49,39,60,38,186
4733,62,27,48,39,176
1161,50,48,66,65,229
398,67,7,36,43,153
6867,51,65,38,35,189
7033,52,51,48,63,214
3055,49,42,58,38,187
440,57,47,42,37,183
5323,55,30,39,45,169
9136,49,43,100,51,243
5944,61,47,46,69,223
2594,79,41,64,34,218
8083,66,67,69,70,272
1611,54,66,59,48,227
431,39,34,51,55,179
8409,26,58,37,56,177
3038,64,76,55,31,226
8688,39,33,46,53,171
643,68,36,54,70,228
7620,64,35,34,34,167
1642,59,54,24,55,192
6323,36,31,58,49,174
2400,46,60,46,47,199
887,36,42,84,37,199
1417,71,37,45,60,213
6024,37,55,32,80,204
3639,36,60,57,49,202
3015,52,77,67,42,238
4773,66,72,71,36,245
2518,57,41,43,51,192
6551,42,65,27,52,186
1289,43,51,54,18,166
6606,58,48,22,57,185
7814,62,27,90,22,201
7380,36,43,34,41,154
7021,4,74,54,61,193
5251,60,80,54,52,246
8532,42,44,54,60,200
1636,72,36,53,31,192
6236,65,27,32,45,169
8978,53,60,51,47,211
5968,38,74,34,50,196
4027,33,30,44,49,156
5952,53,57,33,46,189
2800,48,56,88,49,241
2040,44,64,58,44,210
227,35,19,58,54,166
3155,74,68,56,38,236
7111,50,66,44,60,220
3914,70,74,52,57,253
7435,23,45,62,60,190
2989,64,23,54,42,183
5604,57,65,67,78,267
366,40,46,49,34,169
6272,51,25,55,62,193
5504,59,39,63,64,225
9700,62,30,26,51,169
6282,50,50,44,54,198
2515,46,47,55,48,196
4297,52,70,36,47,205
4544,77,58,59,60,254
2203,64,46,49,24,183
5332,39,71,57,44,211
4753,86,46,40,68,240
8335,61,33,67,24,185
9590,61,44,38,64,207
9565,42,51,49,77,219
4214,40,42,68,49,199
1852,74,55,70,53,252
5412,47,37,48,50,182
1587,31,38,74,17,160
6854,49,50,64,49,212
6407,55,38,62,45,200
6033,32,70,52,56,210
1545,44,42,38,32,156
6891,60,38,47,16,161
9645,44,75,49,66,234
5627,35,72,25,68,200
888,69,47,60,18,194
9338,40,57,37,41,175
9579,42,30,53,68,193
8263,79,50,36,38,203
6103,58,35,60,72,225
6435,47,32,41,30,150
7356,52,39,45,53,189
9981,56,29,40,63,188
6157,66,47,43,26,182
1939,55,78,60,47,240
7023,37,17,53,55,162
1218,47,43,49,37,176
7034,59,51,37,48,195
4060,26,62,10,36,134
1916,39,68,76,31,214
7056,38,14,70,61,183
2485,30,63,28,17,138
4134,66,62,47,42,217
3573,66,55,34,39,194
5019,51,59,20,54,184
9616,67,79,21,56,223
840,53,29,44,43,169
5365,56,13,42,60,171
3715,55,46,65,58,224
2894,64,41,47,42,194
7824,54,40,63,35,192
8549,67,48,68,46,229
6810,53,45,62,61,221
2337,57,54,54,33,198
2759,12,47,45,24,128
4552,60,56,47,68,231
4829,26,33,41,54,154
4523,74,38,23,57,192
6706,39,69,54,71,233
209,55,44,32,31,162
7161,23,36,40,41,140
2249,21,48,39,89,197
6063,59,54,55,49,217
8111,64,61,50,30,205
5753,49,34,43,32,158
5277,57,38,36,55,186
1853,51,18,60,54,183
6281,63,48,49,54,214
4982,71,13,18,37,139
8965,3,58,46,79,186
8836,55,48,34,58,195
4869,54,51,47,52,204
4336,52,40,54,30,176
8888,39,51,60,52,202
4509,54,45,60,47,206
9924,55,63,51,56,225
2170,46,58,64,60,228
3350,56,55,65,47,223
8260,47,18,60,42,167
3817,68,34,40,37,179
4669,34,58,41,45,178
2620,60,53,48,48,209
8150,19,43,78,38,178
687,29,40,28,54,151
3307,19,51,92,19,181
3651,58,25,84,60,227
3439,51,73,68,83,275
1006,77,49,25,47,198
984,15,71,79,53,218
3145,42,59,30,35,166
2813,41,30,44,21,136
5263,42,52,29,14,137
8094,58,46,64,15,183
6594,58,52,30,38,178
9697,48,66,83,50,247
7724,29,42,64,37,172
7049,9,44,36,20,109
7210,71,52,24,54,201
9373,38,56,53,36,183
8274,58,45,56,35,194
3094,70,38,60,39,207
8940,46,43,70,73,232
877,95,57,66,44,262
5236,56,61,62,36,215
922,56,50,66,49,221
8284,57,49,63,48,217
3650,20,46,63,29,158
1418,61,29,21,24,135
326,30,43,54,51,178
4838,72,41,35,52,200
1756,48,62,63,74,247
2875,56,57,38,43,194
638,77,46,47,49,219
4898,48,76,49,55,228
7570,30,36,83,62,211
688,69,13,51,61,194
4681,34,46,30,43,153
7592,61,45,42,38,186
5337,30,67,38,47,182
2890,51,61,44,44,200
3855,37,42,58,56,193
7630,45,37,39,51,172
1292,19,73,58,68,218
7064,59,42,53,58,212
1431,27,62,51,83,223
8684,64,52,68,54,238
7088,61,80,34,31,206
5602,58,23,57,66,204
8954,36,30,68,64,198
9694,68,53,60,36,217
1067,33,29,41,53,156
9709,24,55,38,30,147
4141,46,64,32,53,195
7940,18,61,42,69,190
9984,63,38,44,50,195
3267,16,57,76,46,195
6313,77,24,48,50,199
8427,38,67,57,47,209
553,41,61,32,61,195
4117,52,51,66,54,223
4854,55,80,39,44,218
4686,51,44,64,69,228
4463,44,53,37,65,199
6886,53,23,16,80,172
1341,62,50,37,55,204
699,49,30,59,60,198
6896,59,44,81,30,214
7060,41,45,59,63,208
5910,6,40,65,56,167
7746,61,57,56,38,212
1535,62,46,30,73,211
6106,45,65,44,67,221
5524,46,28,38,54,166
8492,36,45,54,46,181
5406,28,75,51,46,200
6693,48,56,43,49,196
8712,29,33,64,50,176
2141,22,65,35,61,183
7454,55,41,50,57,203
9713,63,70,39,35,207
7260,22,60,34,40,156
4331,55,49,53,62,219
5964,47,45,89,57,238
4635,52,34,0,53,139
6936,40,65,35,29,169
9122,54,53,34,44,185
9762,27,55,42,20,144
1484,37,48,44,55,184
8237,46,49,48,29,172
4012,57,65,49,61,232
3171,45,59,54,55,213
9880,49,68,43,35,195
3437,84,36,19,64,203
1506,54,39,74,61,228
5821,56,22,42,49,169
3423,46,48,28,67,189
3194,51,10,62,55,178
4267,76,56,45,57,234
4392,65,41,41,26,173
8792,48,63,25,29,165
5580,46,62,53,33,194
7008,73,55,40,63,231
1381,18,40,65,53,176
3609,33,69,57,80,239
5132,80,67,67,56,270
759,45,64,45,55,209
4093,37,50,38,44,169
7160,65,47,45,51,208
5273,78,45,42,28,193
7014,64,54,26,55,199
8562,23,33,57,76,189
5556,57,69,40,52,218
2747,42,61,62,33,198
7465,52,56,27,40,175
9206,44,27,57,45,173
899,35,20,48,23,126
8953,42,37,44,61,184
4209,67,68,53,39,227
3660,39,69,57,50,215
5864,49,47,78,33,207
9194,79,34,55,25,193
9792,61,59,26,55,201
8979,39,51,35,47,172
3784,48,27,41,38,154
4433,59,55,43,72,229
2069,68,25,34,33,160
5009,25,89,64,18,196
1191,63,40,54,33,190
5395,63,37,77,48,225
2695,30,45,75,55,205
3293,64,73,77,56,270
1864,53,57,46,43,199
6731,41,33,49,65,188
2683,26,66,65,58,215
4186,39,26,61,43,169
3178,74,49,59,60,242
119,71,44,60,25,200
9592,30,28,37,49,144
6382,50,69,46,60,225
9922,83,39,46,25,193
8415,69,77,25,25,196
2537,42,72,20,44,178
970,68,56,40,40,204
2404,71,49,45,57,222
1838,46,66,52,36,200
2458,38,51,49,66,204
7672,57,56,55,40,208
9787,59,36,69,24,188
7978,47,62,58,56,223
449,57,76,60,51,244
4572,74,42,85,43,244
4886,49,64,57,47,217
5706,32,66,28,41,167
5167,30,60,35,44,169
1835,53,39,32,43,167
9067,68,79,66,28,241
5822,47,48,49,31,175
3122,47,67,22,55,191
5574,63,88,41,19,211
1635,68,56,49,54,227
167,54,31,24,42,151
5699,37,49,44,20,150
4685,62,57,60,63,242
9317,36,64,53,71,224
4534,58,55,60,52,225
9625,56,41,36,67,200
2136,33,72,48,33,186
7264,47,35,28,38,148
1882,42,58,43,32,175
3132,70,52,47,58,227
1458,41,58,47,38,184
8473,57,60,56,42,215
5786,26,54,40,33,153
3553,56,54,38,18,166
9014,63,23,49,54,189
5726,12,45,45,21,123
4310,50,45,37,57,189
8567,57,74,30,41,202
103,59,72,66,67,264
2101,38,45,74,78,235
5402,54,27,62,55,198
3775,35,69,26,46,176
2536,3,42,43,73,161
3301,70,28,33,43,174
464,56,59,42,31,188
4765,31,71,47,34,183
4757,42,71,62,46,221
8976,44,75,72,45,236
4029,45,30,41,62,178
4183,31,21,33,64,149
3577,46,54,38,31,169
6772,44,54,43,33,174
5348,70,11,53,62,196
7740,44,81,31,29,185
7936,34,66,68,40,208
6154,37,20,54,72,183
2958,40,21,54,62,177
1041,44,44,61,41,190
6755,50,69,45,55,219
1248,49,88,31,58,226
7906,59,35,64,31,189
6009,60,58,48,28,194
2016,30,50,49,59,188
5427,44,38,49,39,170
2655,51,32,59,23,165
3018,45,45,68,39,197
625,40,27,10,40,117
8853,38,43,56,63,200
9669,44,28,64,27,163
7819,44,64,28,74,210
9128,47,56,42,13,158
4743,50,74,65,46,235
9064,47,34,68,46,195
521,58,52,35,44,189
976,29,48,49,38,164
1158,30,40,48,70,188
444,66,53,23,49,191
2656,45,43,50,63,201
3694,52,49,27,70,198
9783,40,37,35,16,128
8173,45,42,47,63,197
3736,34,37,50,64,185
4998,31,64,51,73,219
4641,53,50,57,79,239
5526,52,36,58,42,188
3666,67,70,64,71,272
2811,25,48,49,55,177
5956,33,68,62,26,189
6261,40,54,71,62,227
4557,59,14,57,54,184
1672,46,22,28,59,155
1290,47,55,41,66,209
1373,40,39,58,57,194
6538,57,78,49,58,242
9862,53,45,60,81,239
3152,24,49,55,46,174
2191,41,52,52,45,190
5494,55,55,51,84,245
4168,54,71,62,41,228
5008,52,37,57,42,188
8424,54,36,69,27,186
2298,71,38,64,53,226
5461,74,52,55,36,217
3904,64,7,55,74,200
3120,20,30,53,58,161
3085,54,70,33,37,194
2906,29,42,42,42,155
219,63,35,45,45,188
7278,72,63,68,39,242
144,66,74,49,34,223
5801,39,37,68,22,166
2783,61,55,48,29,193
8117,54,94,39,24,211
747,61,44,57,64,226
6055,39,41,98,35,213
3010,14,54,71,61,200
1729,31,52,30,64,177
3467,54,61,64,72,251
542,57,48,67,34,206
2145,67,76,19,67,229
3563,42,50,40,51,183
1200,54,47,53,88,242
7239,35,53,41,49,178
6320,53,67,38,40,198
4262,38,53,40,75,206
1523,63,63,69,45,240
3115,67,36,34,19,156
2718,44,69,41,77,231
4034,39,39,68,57,203
1669,48,64,40,47,199
1781,57,35,66,17,175
7156,38,39,47,53,177
8860,62,79,47,68,256
3237,68,49,21,41,179
5923,14,26,31,55,126
1346,21,70,37,56,184
7319,39,39,33,69,180
4445,35,4,67,68,174
3517,32,41,33,62,168
1271,35,41,45,14,135
2304,71,64,42,29,206
134,48,72,62,31,213
7834,71,55,69,63,258
5238,31,54,18,47,150
4662,36,39,33,68,176
4354,71,49,58,34,212
1019,53,27,59,45,184
1701,31,37,52,57,177
3999,64,60,48,73,245
1899,57,55,61,25,198
4908,52,49,43,67,211
2687,53,52,57,47,209
1719,44,57,47,44,192
7961,31,51,57,59,198
3034,26,38,58,51,173
2804,46,29,19,84,178
9099,36,76,18,20,150
959,63,44,53,49,209
2568,53,69,65,42,229
3119,52,34,31,69,186
9763,51,68,28,39,186
9513,58,67,15,31,171
5423,42,31,60,46,179
1333,63,53,64,77,257
9989,36,73,34,70,213
1111,55,43,55,76,229
5654,77,29,42,43,191
3239,28,57,42,65,192
8251,49,52,44,56,201
6239,62,51,60,60,233
1846,40,60,81,28,209
2402,64,59,49,29,201
510,49,32,68,26,175
789,49,51,72,70,242
5232,34,85,52,62,233
8341,63,43,50,57,213
7359,32,66,57,67,222
3435,68,58,55,85,266
7397,46,55,39,41,181
4587,79,49,59,44,231
9115,57,81,27,26,191
3057,37,48,46,45,176
5710,71,56,59,36,222
5415,46,26,53,46,171
244,26,23,66,14,129
816,66,53,38,32,189
4643,46,80,61,62,249
6716,65,39,25,64,193
9637,45,55,44,45,189
2363,55,41,35,56,187
2208,48,70,49,12,179
3365,42,62,23,95,222
6658,27,44,56,61,188
5704,69,69,28,46,212
4808,60,28,54,35,177
6812,29,67,43,34,173
9098,50,57,43,87,237
8488,60,52,59,55,226
375,34,59,41,52,186
916,58,63,49,43,213
6853,43,69,35,0,147
1539,50,64,62,49,225
8626,33,44,57,46,180
6757,64,46,55,56,221
4917,37,72,56,39,204
1195,72,51,43,60,226
4496,60,63,32,52,207
6496,96,30,40,37,203
8436,42,53,13,45,153
7233,71,46,71,47,235
7518,38,55,32,26,151
4665,36,27,64,60,187
8754,70,44,32,67,213
9671,56,60,41,21,178
6161,58,52,38,53,201
4345,51,16,24,39,130
1452,32,56,57,45,190
8848,40,37,48,54,179
485,45,64,38,70,217
4424,69,58,69,57,253
9808,73,56,54,45,228
2048,32,26,65,75,198
7144,64,61,41,24,190
255,52,73,34,7,166
8175,43,66,59,48,216
8120,48,75,53,32,208
1033,74,38,68,73,253
9821,38,44,50,50,182
1504,50,51,56,42,199
2957,23,52,33,34,142
5256,66,55,22,72,215
7793,32,45,44,79,200
7287,76,43,32,63,214
3118,61,40,47,41,189
2333,73,43,80,45,241
9372,53,69,49,56,227
7373,51,56,74,86,267
9870,61,48,14,40,163
8690,28,39,59,58,184
575,33,47,79,52,211
1035,45,86,56,28,215
8619,42,47,49,75,213
8966,41,38,71,58,208
6046,58,64,49,65,236
1363,62,39,23,60,184
3019,55,47,33,42,177
6474,49,41,40,52,182
2740,61,33,26,54,174
884,36,38,60,57,191
2336,51,60,66,66,243
5674,46,38,72,39,195
1000,60,34,63,57,214
87,24,66,38,38,166
6766,24,48,47,51,170
2487,30,42,51,47,170
7245,86,56,41,55,238
9588,27,65,43,81,216
1765,52,55,77,53,237
1855,75,56,26,29,186
2939,71,30,65,34,200
7271,43,46,40,38,167
1555,33,58,94,52,237
1913,25,30,16,36,107
723,56,44,76,46,222
3095,22,46,25,34,127
2892,31,48,25,70,174
6572,99,47,77,51,274
977,82,42,53,41,218
1226,46,29,56,45,176
3196,50,45,12,35,142
3722,47,52,34,52,185
3543,15,78,57,61,211
4213,40,26,72,36,174
8476,58,67,41,73,239
3750,36,50,23,49,158
3420,65,36,60,35,196
6393,47,52,16,69,184
4257,32,45,42,49,168
5138,74,54,37,65,230
9847,60,52,58,61,231
1352,47,36,49,38,170
6957,63,36,35,14,148
4620,35,40,71,67,213
174,71,43,70,45,229
8645,31,47,42,48,168
2741,48,61,67,58,234
2847,66,17,37,45,165
727,67,53,49,25,194
3113,62,33,44,45,184
7552,19,44,73,79,215
9261,69,30,63,31,193
5123,54,44,49,75,222
3447,73,57,57,33,220
839,41,25,57,71,194
9173,82,66,61,37,246
7330,42,56,49,49,196
9330,40,51,37,29,157
3473,45,23,26,42,136
3535,8,47,61,48,164
5564,31,71,37,46,185
7009,29,32,70,52,183
1388,51,10,21,62,144
5010,52,36,38,49,175
4763,35,57,56,59,207
5530,53,56,62,58,229
44,55,84,66,27,232
1029,42,74,60,32,208
2691,46,75,32,59,212
7679,54,42,58,45,199
1287,56,42,29,77,204
8012,41,23,55,54,173
4378,55,31,36,39,161
328,28,71,47,18,164
5210,46,43,100,52,241
4215,50,58,60,33,201
3950,46,52,52,64,214
1357,42,64,65,31,202
9419,63,44,48,41,196
7522,76,56,36,61,229
6908,49,74,54,77,254
8321,53,30,69,45,197
1472,36,73,49,71,229
4726,36,63,42,39,180
7074,43,38,19,64,164
1114,49,18,75,50,192
5068,32,38,51,38,159
3317,78,20,57,13,168
3031,87,39,73,25,224
195,42,48,53,43,186
402,34,25,21,82,162
4540,63,62,48,36,209
4921,51,72,92,40,255
6420,38,59,31,52,180
5666,40,63,44,34,181
1973,46,53,42,62,203
6389,47,61,41,77,226
4325,51,39,45,50,185
9781,94,68,52,42,256
4993,26,44,42,17,129
8015,77,40,56,39,212
6534,25,72,59,51,207
6543,71,100,36,39,246
733,50,43,62,65,220
0,42,41,54,81,218
3049,23,44,54,39,160
6939,49,9,57,31,146
4421,81,37,50,66,234
3514,33,59,42,66,200
6986,84,57,53,52,246
13,42,52,11,71,176
9316,73,44,38,65,220
7811,36,35,39,32,142
5632,25,58,63,39,185
9572,34,36,36,48,154
3234,22,44,41,22,129
3486,25,16,40,24,105
5252,60,22,35,36,153
6450,72,58,50,37,217
1885,69,60,44,35,208
7389,26,60,54,58,198
1212,31,22,52,46,151
1288,56,22,49,24,151
9618,41,73,44,66,224
703,40,41,39,64,184
2420,89,38,57,80,264
702,37,75,43,45,200
7762,42,40,39,67,188
4018,63,51,54,50,218
7201,19,27,34,60,140
5596,64,66,41,31,202
3610,63,38,84,70,255
8495,77,23,36,44,180
246,18,88,55,30,191
5760,31,53,71,59,214
3890,67,45,65,78,255
6752,36,84,34,57,211
468,39,6,41,52,138
3638,27,17,51,36,131
6207,23,67,47,51,188
9407,58,36,30,53,177
5806,66,59,36,58,219
5385,51,59,51,44,205
7103,31,28,36,55,150
5773,63,8,27,54,152
6286,25,88,70,56,239
7650,14,38,44,35,131
5288,47,68,60,63,238
6430,56,60,42,34,192
2196,73,53,48,51,225
9152,48,59,32,41,180
3707,37,36,97,33,203
7833,59,28,70,71,228
8554,33,60,65,39,197
7325,56,38,18,53,165
5296,89,47,13,41,190
4903,19,52,47,37,155
8026,59,44,46,31,180
4530,25,61,69,69,224
1726,31,88,53,47,219
5310,65,35,65,27,192
3238,48,39,54,55,196
4353,68,36,50,21,175
9172,72,29,34,44,179
6483,51,24,51,48,174
4152,66,52,36,52,206
2042,33,57,59,53,202
637,54,73,35,64,226
3291,62,42,39,76,219
2648,54,42,64,39,199
4423,51,62,25,47,185
2814,35,36,52,52,175
1075,30,59,42,28,159
9,58,27,50,39,174
5025,36,32,50,29,147
3413,35,46,36,0,117
5128,41,67,56,64,228
7114,32,67,43,72,214
8428,28,38,32,54,152
3482,50,54,39,34,177
5553,30,51,48,43,172
9050,71,51,35,41,198
2855,36,65,33,35,169
500,64,55,43,58,220
583,55,59,54,12,180
1571,51,50,71,53,225
4342,24,45,38,40,147
9622,36,60,75,58,229
987,48,55,79,25,207
4834,32,45,31,72,180
6989,51,60,55,21,187
6924,41,50,24,23,138
2530,22,68,46,55,191
2767,27,42,41,35,145
7947,31,56,27,41,155
4872,49,0,47,57,153
3053,58,51,58,60,227
4081,65,31,65,62,223
5622,54,81,26,25,186
1347,37,36,61,79,213
4078,32,43,42,40,157
1368,60,60,47,37,204
3461,63,59,37,44,203
7058,60,49,67,46,222
7411,61,29,39,60,189
1455,41,68,73,78,260
4305,57,48,59,52,216
4694,66,78,36,34,214
620,36,51,67,42,196
1470,75,37,69,44,225
6525,66,51,33,66,216
9183,15,45,87,35,182
7707,62,40,44,73,219
7091,73,38,56,40,207
3466,51,40,44,45,180
9345,44,45,67,55,211
8811,54,38,24,63,179
4929,65,10,54,45,174
4160,27,53,45,50,175
1173,66,32,60,53,211
2983,52,62,29,62,205
8282,60,35,21,64,180
771,40,42,46,34,162
6038,72,54,34,45,205
8738,59,8,55,30,152
9594,46,34,60,42,182
1910,57,64,69,83,273
2812,70,32,34,35,171
158,49,58,74,46,227
5787,22,68,58,39,187
6440,52,66,37,61,216
3969,35,15,54,39,143
6177,45,68,44,38,195
4464,32,33,47,62,174
3951,59,61,66,24,210
1553,61,37,52,18,168
7830,49,33,43,68,193
623,51,68,50,50,219
7449,50,14,19,77,160
8775,46,41,24,35,146
4855,48,29,81,75,233
8752,28,56,46,52,182
6196,36,58,39,40,173
5014,34,56,46,38,174
8340,37,0,80,38,155
7458,80,63,74,49,266
1193,67,65,37,68,237
5244,52,55,58,21,186
3380,39,52,39,41,171
4210,21,59,43,36,159
4596,34,35,54,53,176
5492,50,58,51,42,201
202,46,11,67,54,178
2574,31,46,39,44,160
3326,59,73,56,42,230
6118,34,49,38,46,167
2517,52,35,59,70,216
5452,37,37,46,45,165
8402,63,39,70,47,219
918,76,27,40,73,216
9894,58,32,67,33,190
8066,70,49,50,34,203
57,47,39,43,24,153
223,84,57,63,60,264
3193,30,99,60,41,230
4163,45,33,63,60,201
9591,42,68,59,78,247
4531,56,44,36,51,187
9992,27,60,63,37,187
7958,53,29,58,31,171
1345,53,45,28,72,198
8421,30,53,58,30,171
952,24,71,35,57,187
709,27,53,84,56,220
3964,45,24,56,60,185
6517,40,78,52,71,241
7750,59,88,34,35,216
561,82,21,46,50,199
1336,36,69,58,53,216
4793,74,63,37,68,242
8432,43,72,59,62,236
5735,20,46,43,38,147
7177,67,25,67,4,163
2567,42,64,14,33,153
3613,56,66,41,38,201
2116,45,64,37,43,189
9760,55,43,72,56,226
3919,71,56,12,55,194
1878,56,23,47,41,167
8085,25,43,53,40,161
4794,53,50,61,26,190
1492,46,27,51,58,182
8531,51,39,33,65,188
9298,41,49,64,48,202
9452,61,44,36,52,193
8609,59,32,48,68,207
9202,51,55,49,22,177
1448,68,34,36,40,178
986,58,34,80,31,203
3342,58,55,46,44,203
4691,83,35,51,21,190
1986,41,47,43,39,170
8451,69,62,52,58,241
148,63,33,27,61,184
1125,48,31,47,34,160
4673,66,38,46,40,190
7413,58,46,76,52,232
1514,46,38,64,60,208
3735,38,60,59,57,214
235,64,69,54,22,209
2362,41,40,53,43,177
2055,31,60,48,63,202
7343,66,35,43,55,199
7954,41,33,50,64,188
6673,68,48,59,51,226
4045,51,40,56,22,169
3867,31,34,50,50,165
4825,46,37,53,34,170
7038,47,65,62,41,215
3592,37,68,42,52,199
964,77,35,49,83,244
9945,37,35,54,67,193
9793,63,66,44,55,228
6135,63,57,58,73,251
4068,49,51,49,41,190
5839,45,40,56,40,181
6151,49,68,44,69,230
3674,65,55,35,66,221
863,42,48,48,33,171
3033,47,54,26,58,185
8778,58,73,72,33,236
9915,35,68,36,66,205
9573,54,48,32,42,176
1577,54,52,80,48,234
6923,43,45,91,53,232
9635,34,28,51,54,167
3863,47,44,49,86,226
7509,41,66,47,52,206
7766,29,54,56,62,201
6047,41,25,53,42,161
1107,51,54,39,48,192
3911,68,75,38,64,245
6084,34,72,62,60,228
3909,64,34,58,40,196
7284,79,57,57,36,229
4442,43,44,55,28,170
7986,53,71,51,61,236
501,53,28,42,34,157
413,56,53,31,67,207
6550,21,36,28,52,137
1164,41,16,69,27,153
5286,49,56,63,57,225
9800,21,84,52,36,193
8903,50,50,53,73,226
4676,40,49,58,62,209
2589,36,20,56,26,138
1828,38,39,19,48,144
5516,35,63,42,44,184
1967,53,41,30,41,165
6725,51,47,78,48,224
6493,59,51,45,68,223
710,62,62,39,38,201
1859,38,73,44,46,201
1616,43,50,47,75,215
7422,52,52,46,38,188
6541,54,55,30,79,218
2552,71,59,36,47,213
5934,40,75,21,47,183
5557,77,31,56,60,224
1152,44,29,54,53,180
9627,77,32,16,61,186
6648,44,69,62,47,222
2245,39,41,70,5,155
4887,41,29,31,40,141
252,46,31,48,37,162
52,68,50,46,34,198
5749,33,63,68,51,215
3303,50,76,61,46,233
2044,44,54,45,69,212
9123,59,19,21,40,139
6125,36,63,65,67,231
1598,51,75,63,50,239
971,73,50,59,27,209
1259,53,45,41,30,169
3046,59,35,29,53,176
4519,57,57,56,69,239
5841,83,21,32,95,231
2422,36,78,74,51,239
1441,19,48,54,49,170
7840,74,61,34,65,234
9597,36,47,56,64,203
3331,57,25,24,53,159
63,62,45,36,44,187
3154,41,62,41,49,193
5691,73,49,36,15,173
6510,59,45,76,50,230
4766,59,45,60,32,196
2445,58,68,70,46,242
9389,50,63,36,47,196
2675,64,49,64,65,242
2661,45,58,45,70,218
2998,35,31,55,57,178
1086,70,66,38,58,232
9818,64,18,34,95,211
9704,91,59,25,60,235
3693,61,75,53,38,227
4313,72,71,50,59,252
3847,47,38,65,43,193
7555,60,51,43,73,227
4776,69,55,44,11,179
8705,58,67,49,35,209
7745,38,37,23,29,127
6911,20,27,53,36,136
8804,61,51,100,31,243
2426,45,60,47,28,180
6987,13,41,54,49,157
3806,44,52,80,79,255
801,69,58,49,71,247
9446,45,45,44,51,185
3316,13,71,57,29,170
9707,72,52,53,28,205
3483,45,55,63,34,197
5535,56,90,39,73,258
5879,47,25,55,74,201
6581,61,37,44,14,156
3798,56,50,51,42,199
1428,54,0,42,75,171
3351,88,72,21,39,220
9938,31,47,53,57,188
9729,36,29,18,81,164
3936,31,42,15,48,136
8095,36,48,28,45,157
2763,46,35,33,59,173
3896,53,38,61,43,195
4001,18,62,85,49,214
1527,52,55,78,70,255
3868,37,49,69,39,194
8375,47,17,50,77,191
2599,51,40,37,45,173
835,65,45,41,66,217
264,25,29,57,19,130
2211,59,43,49,59,210
3649,71,59,93,70,293
7779,64,64,43,26,197
7715,52,45,79,49,225
5681,32,45,60,44,181
4591,27,42,59,47,175
4222,48,87,42,7,184
4373,60,96,61,64,281
4241,31,53,65,100,249
1769,45,52,72,97,266
1905,42,44,22,51,159
2899,43,40,48,28,159
2690,39,39,68,79,225
3629,57,38,52,23,170
5161,51,80,54,57,242
198,59,68,25,33,185
4521,52,31,59,47,189
5715,27,56,37,41,161
8886,37,55,35,29,156
2669,53,42,43,65,203
8520,32,76,33,51,192
3612,30,49,79,45,203
3226,74,67,60,22,223
7096,44,44,24,29,141
7134,31,34,44,64,173
7794,58,37,53,63,211
6626,47,20,54,54,175
8323,28,52,45,58,183
6749,46,48,50,58,202
9032,55,49,44,13,161
5640,16,39,75,35,165
3180,63,33,43,63,202
6182,58,52,75,45,230
5066,53,49,44,46,192
5744,57,55,39,43,194
7027,38,72,50,51,211
